geoid10,los_dist_score,los_acre_score,los_exp_score,los_total_score,la_dist_score,la_acre_score,la_exp_score,la_total_score,gw_score_loop_contiguous,los_gw_total_score,la_gw_total_score,totpop_2018,area,popdensity_sqmi,tothh_2018
"371830527072016","2","3","3","8","2","3","4","9","2","10","11",0,0.0219220876619523,0,"0"
"371830538084019","3","3","3","9","3","3","3","9","3","12","12",0,0.0171358594725261,0,"0"
"371830515022025","4","5","4","13","4","5","5","14","5","18","19",47,0.012341216668414,3808.37653716035,"20"
"371830516002003","3","4","4","11","3","4","5","12","3","14","15",53,0.00257404758051068,20590.1399808177,"33"
"371830506003022","5","5","5","15","5","5","5","15","5","20","20",16,0.00481582560943612,3322.37944178245,"9"
"371830537171001","2","5","1","8","2","5","2","9","2","10","11",0,0.00936532645193796,0,"0"
"371830540012001","2","2","3","7","2","2","4","8","2","9","10",48,0.0205502973342256,2335.73262806559,"22"
"371830525051007","3","3","4","10","3","3","4","10","5","15","15",7,0.00112431006353137,6226.04050880196,"2"
"371830537162002","5","5","4","14","5","5","4","14","5","19","19",43,0.00479756780055368,8962.87489569974,"27"
"371830525043025","5","5","4","14","5","5","5","15","4","18","19",0,0.000261878490367236,0,"0"
"371830524011079","1","5","2","8","2","5","2","9","3","11","12",0,0.00343903419040803,0,"0"
"371830540131049","3","5","3","11","3","5","3","11","5","16","16",120,0.0198931754071355,6032.21946944463,"66"
"371830540182006","2","4","3","9","2","4","3","9","2","11","11",0,0.00430833254777559,0,"0"
"371830541042008","4","3","2","9","4","3","2","9","3","12","12",127,0.00731046287565722,17372.360979069,"26"
"371830527011013","5","3","4","12","5","3","4","12","2","14","14",71,0.0179290598042854,3960.05149043172,"28"
"371830516001006","3","4","5","12","5","4","5","14","3","15","17",0,0.000755990448049004,0,"0"
"371830518002022","5","4","5","14","5","4","5","14","4","18","18",13,0.00720190967159663,1805.07679112809,"9"
"371830537231009","3","1","2","6","3","1","3","7","3","9","10",0,0.00810360292615469,0,"0"
"371830526032014","5","3","4","12","5","4","5","14","5","17","19",349,0.0249477770754931,13989.2223240536,"196"
"371830523011005","5","5","4","14","5","5","4","14","5","19","19",34,0.0054116379959181,6282.75579882571,"16"
"371830524062023","1","5","2","8","2","5","3","10","3","11","13",25,0.00356403284213671,7014.52570931193,"24"
"371830524062015","1","2","2","5","2","2","2","6","3","8","9",0,0.000920555452645883,0,"0"
"371830521014033","4","4","5","13","4","4","5","13","4","17","17",163,0.0613016577660982,2658.98192544712,"57"
"371830540142008","4","2","1","7","4","3","2","9","3","10","12",11,0.0102066189612256,1077.73201309743,"5"
"371830528061001","2","1","1","4","2","1","1","4","3","7","7",18,0.0139424404378219,1291.02219086202,"6"
"371830530082004","2","3","2","7","2","3","2","7","2","9","9",20,0.00947138507843874,2111.62357293753,"8"
"371830528061030","2","2","2","6","3","3","3","9","4","10","13",0,0.00205784500403056,0,"0"
"371830540082015","3","4","3","10","3","4","4","11","2","12","13",12,0.00123630827644006,9706.3169669574,"4"
"371830515012001","3","3","4","10","3","3","5","11","3","13","14",56,0.0347512314540198,1611.45368543543,"22"
"371830537163000","3","4","3","10","3","4","4","11","5","15","16",202,0.00906919548054538,22273.1994732407,"104"
"371830537191011","1","1","1","3","5","1","2","8","1","4","9",16,0.00215380935677243,7428.698343096,"5"
"371830540072008","1","2","3","6","2","2","3","7","4","10","11",18,0.00329993148603437,5454.65870312088,"5"
"371830540072002","1","3","3","7","2","3","3","8","5","12","13",0,0.000445837800697059,0,"0"
"371830517003004","3","2","3","8","3","2","4","9","4","12","13",0,0.00538632928417317,0,"0"
"371830525043020","5","5","4","14","5","5","4","14","4","18","18",0,0.00412920389497869,0,"0"
"371830525041019","1","5","3","9","1","5","4","10","4","13","14",0,0.00630341676261667,0,"0"
"371830525032017","4","5","3","12","4","5","3","12","4","16","16",45,0.037804512108367,1190.33410273903,"16"
"371839802001022","1","5","2","8","1","5","2","8","5","13","13",0,0.00426113685382044,0,"0"
"371830526011019","3","3","3","9","4","3","4","11","5","14","16",27,0.00827360587259206,3263.38967746129,"13"
"371830503001002","4","4","5","13","5","5","5","15","3","16","18",0,0.00653730966556512,0,"0"
"371830527063005","2","1","3","6","2","1","4","7","3","9","10",1,0.00644466034886844,155.167215317341,"1"
"371830540131032","3","5","2","10","3","5","2","10","5","15","15",4,0.00114702190710191,3487.29172061456,"1"
"371830538071003","4","2","3","9","4","2","3","9","2","11","11",0,0.0133970472714142,0,"0"
"371830527073012","4","4","3","11","4","4","4","12","3","14","15",78,0.00517691529539881,15066.8874318507,"21"
"371830501001021","5","5","5","15","5","5","5","15","4","19","19",58,0.00623814910482012,9297.62963748082,"38"
"371830540131040","4","5","3","12","4","5","3","12","5","17","17",50,0.00642902624607488,7777.22754367764,"29"
"371830541043014","2","2","3","7","5","3","4","12","2","9","14",6,0.018253641941952,328.701528115894,"2"
"371830540083005","2","3","3","8","4","4","4","12","2","10","14",257,0.0243759210170221,10543.1913657963,"94"
"371830540151036","3","3","3","9","3","4","3","10","2","11","12",0,0.00773220974667851,0,"0"
"371830512003030","5","5","5","15","5","5","5","15","4","19","19",18,0.00388653991001778,4631.36888253841,"6"
"371830508003007","5","5","5","15","5","5","5","15","4","19","19",55,0.00339589693494912,16196.0156782037,"16"
"371830517002013","3","4","5","12","5","4","5","14","3","15","17",39,0.00829903975162789,4699.33885933611,"20"
"371830518002014","4","4","5","13","4","4","5","13","3","16","16",91,0.0163600538100111,5562.32889309416,"34"
"371830518002027","5","4","5","14","5","4","5","14","3","17","17",39,0.00575823653299921,6772.90690934619,"14"
"371830503001030","5","5","5","15","5","5","5","15","3","18","18",19,0.00309123267244431,6146.41536671397,"11"
"371830518001033","4","4","5","13","5","4","5","14","3","16","17",82,0.0120564406715563,6801.34396492783,"40"
"371830524081010","4","4","5","13","4","5","5","14","5","18","19",0,0.00106355116774123,0,"0"
"371830501001048","5","5","5","15","5","5","5","15","5","20","20",3,0.00512730763143953,585.102399864728,"1"
"371830541102004","4","2","1","7","4","2","1","7","4","11","11",71,0.00902656532455854,7865.67176407959,"23"
"371830524093006","5","5","4","14","5","5","5","15","4","18","19",151,0.0124270165800839,12150.9454040641,"70"
"371830521021048","2","2","3","7","2","3","4","9","4","11","13",103,0.00627956869585757,16402.400385865,"39"
"371830528064013","1","1","1","3","1","1","1","3","5","8","8",53,0.00565234326997391,9376.64212319586,"15"
"371830528072030","3","1","1","5","3","2","1","6","2","7","8",112,0.0157362374822772,7117.33031012902,"32"
"371830530081044","2","4","2","8","2","4","2","8","3","11","11",0,0.00602362819982225,0,"0"
"371830523013028","2","5","3","10","3","5","3","11","3","13","14",43,0.00116575455170789,36885.9807898693,"12"
"371830523011015","3","5","2","10","3","5","3","11","3","13","14",122,0.0092698006220498,13161.0166145108,"53"
"371830541043034","2","3","3","8","4","4","3","11","3","11","14",54,0.0075168114917518,7183.89706317023,"14"
"371830527072007","2","3","3","8","2","3","4","9","2","10","11",33,0.0153953468404143,2143.50480973717,"15"
"371830506002031","5","4","5","14","5","5","5","15","4","18","19",34,0.00971585563467898,3499.43445831401,"17"
"371830509002025","4","5","5","14","4","5","5","14","5","19","19",0,0.00204417183938872,0,"0"
"371830542091070","2","1","1","4","2","2","1","5","3","7","8",71,0.00689875838807323,10291.7070008926,"24"
"371830541102021","2","1","1","4","2","2","1","5","3","7","8",34,0.00324452716679268,10479.1848710609,"11"
"371830537113011","4","5","3","12","4","5","3","12","5","17","17",53,0.00992325903317561,5340.98725255579,"16"
"371830537121021","3","1","2","6","3","1","2","6","3","9","9",27,0.00478176725117605,5646.44797242265,"8"
"371830537113015","3","5","3","11","3","5","3","11","4","15","15",159,0.0123262921403334,12899.2561745092,"107"
"371830541041046","3","3","3","9","4","4","3","11","2","11","13",0,0.000416578057220942,0,"0"
"371830540082008","4","3","3","10","4","4","4","12","2","12","14",20,0.00242326597731931,8253.32430991526,"10"
"371830540134046","2","5","2","9","2","5","2","9","5","14","14",0,0.00140067574738627,0,"0"
"371830540162015","2","4","2","8","2","4","3","9","2","10","11",0,0.000777181661224728,0,"0"
"371830540182011","2","2","3","7","2","2","3","7","2","9","9",47,0.0098050387185893,4793.45378931478,"28"
"371830540141093","3","3","1","7","3","4","2","9","4","11","13",137,0.0150188736324973,9121.85582969178,"38"
"371830511012005","4","5","5","14","4","5","5","14","5","19","19",33,0.0125363088247857,2632.35378620822,"12"
"371830514004004","5","5","5","15","5","5","5","15","5","20","20",52,0.0104546242359017,4973.87556230185,"30"
"371830501001002","5","4","5","14","5","5","5","15","4","18","19",67,0.00844527514254328,7933.43009779348,"32"
"371830506003026","5","5","5","15","5","5","5","15","5","20","20",13,0.00189116984720861,6874.05206845284,"6"
"371830507001009","5","5","5","15","5","5","5","15","5","20","20",150,0.0106778773481871,14047.7358101015,"61"
"371830507001008","5","5","5","15","5","5","5","15","5","20","20",44,0.00566314950223436,7769.52824265721,"17"
"371830509001016","5","5","5","15","5","5","5","15","5","20","20",734,0.0165388609438199,44380.3235599653,"3"
"371830509001021","5","5","5","15","5","5","5","15","5","20","20",32,0.00371195400054248,8620.79648490347,"18"
"371830509002015","5","5","5","15","5","5","5","15","5","20","20",4,0.0071415294014108,560.104114282552,"3"
"371830501001116","5","5","5","15","5","5","5","15","5","20","20",45,0.00474124587940927,9491.17618966573,"15"
"371830521021045","3","3","4","10","3","4","4","11","4","14","15",16,0.00194726399096799,8216.65684478989,"5"
"371830528064017","1","1","1","3","1","2","1","4","3","6","7",95,0.00749859373650534,12669.0421348622,"27"
"371830528064014","2","1","1","4","2","1","1","4","4","8","8",110,0.00963116702312975,11421.2534925237,"32"
"371830528072011","3","2","2","7","3","3","2","8","3","10","11",36,0.00525603136014337,6849.27420201276,"13"
"371830530031017","1","3","2","6","2","4","2","8","3","9","11",0,0.00511615904388517,0,"0"
"371830523021018","4","5","4","13","4","5","5","14","4","17","18",0,0.00805967222851421,0,"0"
"371830526021006","3","3","4","10","3","3","4","10","3","13","13",63,0.0266733712800654,2361.90616246112,"28"
"371830508002015","2","3","4","9","2","3","4","9","3","12","12",0,0.00770125663199836,0,"0"
"371830510001002","4","5","5","14","5","5","5","15","4","18","19",21,0.00523439433143395,4011.92548178675,"13"
"371830501001060","5","5","5","15","5","5","5","15","4","19","19",0,0.00815254403909169,0,"0"
"371830501001075","5","5","5","15","5","5","5","15","4","19","19",0,0.00294007750921583,0,"0"
"371830501001057","5","5","5","15","5","5","5","15","5","20","20",5,0.00527129883007557,948.532830556358,"2"
"371830528064058","2","1","1","4","2","2","1","5","4","8","9",34,0.00232303014872771,14636.0562813278,"7"
"371830541062023","1","1","1","3","1","1","2","4","2","5","6",0,0.00697555446955873,0,"0"
"371830537241057","2","5","2","9","2","5","2","9","2","11","11",0,0.0174337555048461,0,"0"
"371830542071091","3","5","1","9","3","5","1","9","3","12","12",175,0.0432008995009318,4050.84158019037,"46"
"371830542071089","4","5","1","10","4","5","1","10","3","13","13",132,0.0260248347649249,5072.07831259331,"38"
"371830538084020","4","4","3","11","4","4","3","11","4","15","15",43,0.0401562102484418,1070.81818064912,"12"
"371830514002001","4","5","5","14","4","5","5","14","4","18","18",113,0.0238969004647653,4728.64671996322,"57"
"371830537241066","1","5","2","8","1","5","2","8","2","10","10",0,0.00354251813160424,0,"0"
"371830537121015","5","3","3","11","5","3","3","11","5","16","16",56,0.00810647196161143,6908.06065390599,"15"
"371830537112014","4","5","2","11","4","5","2","11","4","15","15",48,0.0194082181874618,2473.17912115236,"15"
"371830540121000","2","3","3","8","2","3","3","8","3","11","11",140,0.0420110536758882,3332.45628829232,"46"
"371830540163019","2","5","3","10","2","5","3","10","4","14","14",24,0.0064770247806367,3705.40499887369,"9"
"371830527011009","4","3","4","11","4","3","4","11","2","13","13",53,0.0133286052331273,3976.41006489354,"23"
"371830540122004","5","5","4","14","5","5","4","14","2","16","16",19,0.00604137423393944,3144.97981159008,"7"
"371830540141022","4","3","1","8","4","4","2","10","5","13","15",147,0.00990525864590668,14840.6018716884,"42"
"371830515012035","3","4","4","11","4","4","5","13","3","14","16",0,0.000206139351765146,0,"0"
"371830537261011","4","5","3","12","4","5","3","12","4","16","16",0,0.000557128418166398,0,"0"
"371830514001015","5","5","5","15","5","5","5","15","4","19","19",59,0.0217781557242605,2709.13665725492,"24"
"371830514002010","4","5","5","14","4","5","5","14","4","18","18",90,0.0192562365835912,4673.81046183716,"39"
"371830512003012","5","5","5","15","5","5","5","15","4","19","19",43,0.00807174454150773,5327.22508484739,"15"
"371830515012033","3","4","4","11","3","4","5","12","3","14","15",0,0.000973170924739337,0,"0"
"371830506002007","5","4","5","14","5","5","5","15","4","18","19",12,0.0056087674432001,2139.50749813106,"4"
"371830537092007","1","5","2","8","1","5","2","8","3","11","11",67,0.00506149644347702,13237.1919546335,"36"
"371830537161003","4","5","4","13","4","5","4","13","5","18","18",105,0.0262269190728467,4003.52018886995,"53"
"371830537151012","5","5","3","13","5","5","4","14","5","18","19",111,0.0289594848078415,3832.94111537316,"59"
"371830537232009","2","1","2","5","3","1","3","7","4","9","11",2,0.000172755931552999,11577.0265137694,"1"
"371830537093023","1","5","1","7","1","5","1","7","3","10","10",24,0.00700177117389189,3427.70413427546,"12"
"371830537092030","1","5","2","8","1","5","2","8","3","11","11",0,0.0013714136064331,0,"0"
"371830517003002","5","4","4","13","5","4","5","14","5","18","19",0,5.59132639596163e-05,0,"0"
"371830537241089","4","5","3","12","4","5","3","12","2","14","14",0,0.0581960764019957,0,"0"
"371830540043011","3","3","3","9","3","4","4","11","2","11","13",47,0.00308951816219606,15212.7281771964,"27"
"371830537093014","1","5","1","7","1","5","1","7","2","9","9",11,0.00109994600228497,10000.4909124168,"4"
"371830540163020","2","4","2","8","2","4","3","9","4","12","13",120,0.0161604181943003,7425.55041318941,"38"
"371830510002006","5","5","5","15","5","5","5","15","5","20","20",2,0.0274837876688202,72.7701736056183,"1"
"371830524062033","2","4","3","9","3","4","4","11","3","12","14",10,0.00429000905008857,2330.99741358204,"6"
"371830525061008","3","3","3","9","3","3","3","9","3","12","12",0,0.00119028088176235,0,"0"
"371830512003016","5","5","5","15","5","5","5","15","4","19","19",0,0.00208633346344045,0,"0"
"371830505001018","5","4","5","14","5","5","5","15","3","17","18",38,0.00555583040729845,6839.66161927496,"25"
"371830518001002","2","4","4","10","4","4","5","13","5","15","18",0,0.0425178643986187,0,"0"
"371830505003022","4","4","5","13","4","5","5","14","3","16","17",0,0.00543628403316283,0,"0"
"371830505002016","4","4","5","13","5","5","5","15","3","16","18",18,0.0038039233135668,4731.95659223794,"12"
"371830528072061","1","1","1","3","1","1","1","3","2","5","5",3,0.00441646606310718,679.276135519395,"1"
"371830523023033","1","5","3","9","2","5","3","10","3","12","13",88,0.00310584733671891,28333.6527715381,"28"
"371830545003001","2","2","3","7","2","3","4","9","3","10","12",0,0.00230582272405532,0,"0"
"371830530031013","2","3","2","7","2","4","2","8","3","10","11",0,0.00375034445623462,0,"0"
"371830523023000","4","5","3","12","5","5","4","14","3","15","17",43,0.00381078847783327,11283.7540708764,"26"
"371830523013033","2","5","3","10","2","5","3","10","3","13","13",0,0.0134763867938078,0,"0"
"371830545002016","2","3","4","9","2","3","4","9","3","12","12",0,0.00550178666581103,0,"0"
"371830537131001","5","3","3","11","5","3","3","11","5","16","16",47,0.0102703153244624,4576.29571392542,"15"
"371830537111004","5","5","2","12","5","5","2","12","2","14","14",36,0.00564067571521343,6382.2140852566,"9"
"371830540134020","2","5","2","9","2","5","2","9","5","14","14",0,0.000953017149981525,0,"0"
"371830540134007","2","5","2","9","2","5","2","9","5","14","14",29,0.00534829212978764,5422.29169541483,"11"
"371830540141025","4","3","1","8","4","4","2","10","4","12","14",28,0.0018053969282381,15509.0548577178,"12"
"371830511012006","4","4","4","12","4","4","5","13","5","17","18",56,0.0329331348386907,1700.41510698246,"19"
"371830524011093","1","5","3","9","1","5","3","9","5","14","14",0,0.00394749454848262,0,"0"
"371830525043013","5","5","4","14","5","5","4","14","4","18","18",16,0.0216891926593164,737.694586023578,"7"
"371830537091013","1","5","2","8","1","5","2","8","3","11","11",64,0.00387549983651936,16513.9988903933,"39"
"371830526021013","4","2","4","10","4","2","4","10","2","12","12",69,0.0212084599944489,3253.41868377337,"32"
"371830524072008","3","5","4","12","4","5","4","13","3","15","16",0,0.00383178552607043,0,"0"
"371830520024010","4","4","5","13","4","4","5","13","3","16","16",43,0.0100905430928001,4261.41582316634,"16"
"371830524062010","1","5","2","8","2","5","3","10","3","11","13",31,0.00336574978270737,9210.42917666445,"15"
"371830504002007","5","4","5","14","5","4","5","14","3","17","17",85,0.0155762232822552,5457.03528125679,"57"
"371830527051022","3","3","4","10","3","3","4","10","2","12","12",36,0.0039992105610989,9001.77658815444,"16"
"371830541053013","3","2","1","6","3","2","2","7","4","10","11",82,0.00654778701197208,12523.3151063206,"51"
"371830525061010","2","3","3","8","2","3","3","8","3","11","11",66,0.00385104141308656,17138.2213070261,"61"
"371830527071000","2","2","3","7","4","3","3","10","2","9","12",0,0.00166934932070313,0,"0"
"371830527073008","3","3","3","9","3","4","4","11","2","11","13",55,0.00545661912699046,10079.5013762184,"18"
"371830542071041","2","4","1","7","2","4","1","7","2","9","9",56,0.00951714253714527,5884.11908106165,"12"
"371830542081085","1","2","1","4","1","2","1","4","2","6","6",0,0.0395692653328633,0,"0"
"371830528033027","1","2","3","6","1","3","4","8","3","9","11",27,0.00102773219820059,26271.4353479176,"8"
"371830542081120","2","4","1","7","2","5","1","8","3","10","11",3,0.039053591604445,76.8175186135388,"1"
"371830521011035","2","2","3","7","2","2","4","8","2","9","10",61,0.00581845145528958,10483.889135922,"20"
"371830537261002","3","5","2","10","3","5","2","10","4","14","14",94,0.0200097063219825,4697.72012079618,"35"
"371830537191012","1","1","1","3","5","1","2","8","1","4","9",83,0.00755163309437828,10991.000087357,"21"
"371830537252039","1","5","2","8","1","5","2","8","3","11","11",115,0.00834718999855477,13777.0914547184,"62"
"371830524011018","2","5","2","9","2","5","2","9","3","12","12",0,0.0130167014434526,0,"0"
"371830536101007","1","5","1","7","1","5","1","7","1","8","8",0,0.00271358633082912,0,"0"
"371830525072025","1","1","2","4","1","1","2","4","5","9","9",19,0.00622623767056243,3051.60210793619,"8"
"371830540141048","3","4","2","9","3","5","2","10","4","13","14",49,0.00294682775237967,16628.0502687783,"25"
"371830540151042","4","4","3","11","4","4","3","11","2","13","13",0,0.00556816033452631,0,"0"
"371830540151047","4","4","3","11","4","4","3","11","2","13","13",0,0.00517254578387182,0,"0"
"371830540132012","1","4","1","6","1","5","2","8","5","11","13",57,0.0064423465060493,8847.70788818602,"25"
"371830541041024","2","3","2","7","2","4","3","9","3","10","12",0,0.00151660956537177,0,"0"
"371830541041019","1","3","2","6","3","4","3","10","4","10","14",2,0.00278718839605592,717.569003527048,"1"
"371830540171038","2","3","2","7","2","4","2","8","2","9","10",0,0.0277256285034878,0,"0"
"371830537092014","1","5","2","8","1","5","2","8","3","11","11",41,0.00238745760696506,17173.0797985223,"21"
"371830540121011","4","4","4","12","4","4","4","12","2","14","14",29,0.0239625451929687,1210.22202635258,"12"
"371830524093009","4","5","4","13","4","5","4","13","5","18","18",134,0.00676149122770327,19818.1134142382,"66"
"371830511021009","5","5","5","15","5","5","5","15","4","19","19",0,0.00117608757823486,0,"0"
"371830511022009","5","5","5","15","5","5","5","15","5","20","20",0,0.0103933577730522,0,"0"
"371830511023007","5","5","5","15","5","5","5","15","5","20","20",0,0.00213824169364579,0,"0"
"371830512003025","5","5","5","15","5","5","5","15","4","19","19",24,0.00457063600691468,5250.91036864271,"13"
"371830527063034","1","2","4","7","2","3","4","9","4","11","13",0,0.00908173072761657,0,"0"
"371830528072063","2","1","1","4","5","5","2","12","2","6","14",22,0.0288727611364654,761.963841837581,"7"
"371830521011005","4","4","5","13","4","4","5","13","3","16","16",77,0.0175768183400342,4380.7700865076,"37"
"371830530081022","5","5","3","13","5","5","4","14","5","18","19",4,0.00961032164574568,416.219159716754,"3"
"371830535171020","1","5","1","7","2","5","2","9","2","9","11",0,0.0132249444669814,0,"0"
"371830537142006","2","2","3","7","2","2","3","7","3","10","10",182,0.0488785097014185,3723.517781368,"94"
"371830537141007","2","2","3","7","2","2","3","7","3","10","10",29,0.00583435980698697,4970.55391840436,"23"
"371830540071012","2","2","3","7","2","2","3","7","5","12","12",105,0.0221986464223482,4730.01812823564,"37"
"371830536102030","3","5","1","9","3","5","2","10","1","10","11",0,0.00330889482594976,0,"0"
"371830537152017","3","4","3","10","3","4","4","11","4","14","15",38,0.00447840202822522,8485.16943331667,"12"
"371830525042008","3","5","4","12","3","5","4","12","4","16","16",95,0.0169950356693235,5589.8676442014,"59"
"371830524011098","2","5","3","10","2","5","4","11","4","14","15",0,0.00712305874470064,0,"0"
"371830525031013","2","5","2","9","2","5","2","9","3","12","12",0,0.00261884651278287,0,"0"
"371830525043044","3","5","3","11","3","5","4","12","4","15","16",0,0.000459569786242118,0,"0"
"371830537111003","4","1","2","7","4","1","2","7","3","10","10",14,0.00532123028599349,2630.97051763588,"4"
"371830538082020","1","3","3","7","2","3","3","8","5","12","13",43,0.0210880328386534,2039.07117980122,"15"
"371830538083032","4","5","2","11","4","5","3","12","5","16","17",2,0.00160876282694748,1243.19133094023,"2"
"371830538071024","4","3","3","10","4","3","3","10","3","13","13",0,0.00319789389389377,0,"0"
"371830536101080","1","5","1","7","1","5","1","7","1","8","8",81,0.00327827497745676,24708.1164810765,"45"
"371830501001102","5","5","5","15","5","5","5","15","5","20","20",2,0.000968881388632195,2064.23616292545,"1"
"371830537252028","1","5","2","8","1","5","2","8","3","11","11",60,0.0024262604034537,24729.4148289244,"31"
"371830537241021","2","5","1","8","2","5","2","9","2","10","11",0,0.0379995364642067,0,"0"
"371830525072001","2","5","2","9","2","5","2","9","3","12","12",0,0.0141763534918246,0,"0"
"371830537252031","1","5","2","8","1","5","2","8","3","11","11",241,0.00416451382483572,57869.9003381281,"141"
"371830537211016","4","2","2","8","4","2","2","8","3","11","11",3,0.000573149698587792,5234.23462908875,"1"
"371830537112016","3","5","2","10","3","5","2","10","3","13","13",21,0.0210956466168537,995.466049531884,"9"
"371830537241050","2","5","2","9","2","5","2","9","2","11","11",0,0.0043998305105536,0,"0"
"371830537252032","1","5","2","8","1","5","2","8","3","11","11",8,0.0006391940879068,12515.7603165542,"5"
"371830540182000","2","4","3","9","2","4","3","9","2","11","11",0,0.00289511337795728,0,"0"
"371830540084001","2","3","3","8","3","4","4","11","2","10","13",24,0.00275878958245443,8699.46738694285,"12"
"371830540182012","2","2","3","7","2","3","3","8","2","9","10",71,0.00227389241435399,31223.9926356283,"23"
"371830540142009","4","3","1","8","4","4","2","10","3","11","13",20,0.00471051371761063,4245.82141120371,"9"
"371830540134043","2","5","2","9","2","5","2","9","5","14","14",35,0.00609286258661515,5744.42628607583,"13"
"371830545001031","5","5","5","15","5","5","5","15","5","20","20",0,0.000751904746048347,0,"0"
"371830540082007","3","3","3","9","3","3","3","9","2","11","11",0,0.00116577685110527,0,"0"
"371830507001017","5","5","5","15","5","5","5","15","5","20","20",11,0.0023552251752147,4670.46638077706,"6"
"371830506002018","5","4","5","14","5","5","5","15","4","18","19",30,0.00491315025387006,6106.06198667936,"15"
"371830508001008","5","5","5","15","5","5","5","15","5","20","20",39,0.00238153309125368,16376.0059195607,"14"
"371830517002003","4","4","4","12","4","4","5","13","4","16","17",46,0.0143810444772683,3198.65501234704,"22"
"371830516003005","3","4","5","12","4","4","5","13","3","15","16",60,0.0133598830835108,4491.05726636589,"21"
"371830512003004","5","5","5","15","5","5","5","15","4","19","19",45,0.00651596124991269,6906.11841815403,"23"
"371830514005010","5","5","5","15","5","5","5","15","3","18","18",77,0.0102279651632032,7528.37918113177,"38"
"371830516003014","4","4","5","13","4","4","5","13","3","16","16",200,0.0883206909308122,2264.47503854645,"79"
"371830512001003","4","5","5","14","4","5","5","14","3","17","17",11,0.00514111302210674,2139.61450617796,"10"
"371830528063010","4","1","2","7","4","2","2","8","3","10","11",70,0.0148095355802704,4726.68434608141,"26"
"371830541061017","2","2","2","6","2","2","3","7","3","9","10",0,0.0504186119547974,0,"0"
"371830541052022","2","3","3","8","2","3","3","8","3","11","11",94,0.0173596626525754,5414.85176764393,"34"
"371830545003032","2","2","3","7","2","2","3","7","3","10","10",0,0.00437792881403939,0,"0"
"371830545002030","4","4","4","12","4","4","4","12","4","16","16",0,0.00342520170637432,0,"0"
"371830537122000","3","2","2","7","3","2","2","7","3","10","10",0,0.0013558568630299,0,"0"
"371830540043001","5","5","4","14","5","5","4","14","2","16","16",67,0.0107176353502525,6251.37894791515,"29"
"371830540141040","2","2","1","5","3","4","2","9","4","9","13",89,0.00228370375944959,38971.7797817395,"31"
"371830540082004","4","3","3","10","4","3","3","10","2","12","12",44,0.00199646912450951,22038.9083206132,"14"
"371830541043042","3","2","2","7","3","2","2","7","3","10","10",30,0.00207909587257453,14429.3490241271,"11"
"371830527012006","3","3","4","10","3","3","4","10","2","12","12",0,0.00892310486168967,0,"0"
"371830524072019","5","5","4","14","5","5","4","14","3","17","17",36,0.0137086466003097,2626.07980565979,"19"
"371830524041013","4","5","4","13","4","5","4","13","4","17","17",28,0.0105658581832955,2650.04503318695,"11"
"371830511012018","3","5","4","12","3","5","4","12","4","16","16",33,0.00791789259748508,4167.77565415343,"14"
"371830524043007","4","5","4","13","4","5","4","13","4","17","17",58,0.0316513550916777,1832.46498710731,"23"
"371830515012008","4","3","4","11","4","3","5","12","5","16","17",31,0.00726474232436595,4267.18507221185,"10"
"371830505003016","5","4","5","14","5","5","5","15","5","19","20",22,0.00901361050976513,2440.75334475189,"13"
"371830528061032","3","1","1","5","3","2","2","7","4","9","11",32,0.00295862492213475,10815.8353431671,"9"
"371830521013008","2","3","4","9","2","3","4","9","3","12","12",77,0.00331498994000406,23227.82312875,"16"
"371830521013003","2","3","4","9","2","3","4","9","3","12","12",201,0.0137049985301671,14666.1817991124,"54"
"371830530081020","2","4","2","8","2","4","2","8","3","11","11",51,0.00604805471612337,8432.46339422828,"27"
"371830523013022","3","5","3","11","3","5","3","11","3","14","14",0,0.0442913811173248,0,"0"
"371830540121014","2","3","3","8","2","3","3","8","2","10","10",23,0.00616627744162024,3729.96515608558,"7"
"371830540121013","2","4","3","9","2","4","3","9","3","12","12",2,0.013262722973773,150.798595729927,"2"
"371830518003007","4","3","4","11","4","4","5","13","4","15","17",22,0.00863692051185467,2547.20417651219,"15"
"371830541043002","2","2","2","6","4","3","3","10","2","8","12",0,0.000257072166665798,0,"0"
"371830524062007","1","5","3","9","2","5","3","10","3","12","13",0,0.00551533903887532,0,"0"
"371830521021044","5","5","4","14","5","5","4","14","5","19","19",31,0.0113878502768635,2722.19947104347,"8"
"371830523021003","3","5","4","12","3","5","5","13","5","17","18",0,0.000776694466466826,0,"0"
"371830501001069","5","5","5","15","5","5","5","15","5","20","20",0,0.00851440655958449,0,"0"
"371830510002018","5","5","5","15","5","5","5","15","5","20","20",37,0.00539912655058199,6852.96031744461,"19"
"371830545002038","2","2","3","7","2","3","4","9","3","10","12",0,0.00174898772509459,0,"0"
"371830526011018","4","4","4","12","4","4","4","12","4","16","16",16,0.00884940359150492,1808.03144918821,"10"
"371830545001015","5","5","5","15","5","5","5","15","5","20","20",46,0.0076771247670969,5991.82654906817,"20"
"371830545001021","5","5","5","15","5","5","5","15","5","20","20",40,0.00862114715097936,4639.75377052415,"12"
"371830507003015","5","4","5","14","5","5","5","15","4","18","19",38,0.00320797778164035,11845.4685744641,"9"
"371830528033012","1","2","3","6","2","3","3","8","3","9","11",0,0.000629869708179983,0,"0"
"371830528071007","3","1","1","5","3","3","1","7","3","8","10",11,0.0251189206195756,437.916906008594,"5"
"371830528033008","1","2","3","6","5","3","4","12","3","9","15",41,0.00471191975070021,8701.33664604691,"14"
"371830527072020","3","4","4","11","3","4","4","11","3","14","14",22,0.00921945442438007,2386.25833886904,"9"
"371830541052001","2","2","2","6","2","2","2","6","4","10","10",2,0.00620463765654133,322.339532251569,"1"
"371830537121010","5","3","3","11","5","3","3","11","5","16","16",0,0.00269598175120981,0,"0"
"371830540171008","2","4","3","9","2","4","3","9","3","12","12",68,0.0113100662483897,6012.34320883679,"24"
"371830540182001","2","4","3","9","2","5","3","10","2","11","12",0,0.0171837804991202,0,"0"
"371830516001010","3","4","5","12","5","4","5","14","4","16","18",0,0.000316424169327931,0,"0"
"371830503001027","5","5","5","15","5","5","5","15","3","18","18",99,0.00819876989315727,12074.98213636,"76"
"371830516001015","3","4","5","12","4","4","5","13","3","15","16",103,0.0185832537239172,5542.62464099254,"39"
"371830527013013","3","3","4","10","3","3","5","11","4","14","15",0,0.00162537716541422,0,"0"
"371830520011001","2","3","4","9","3","3","5","11","5","14","16",0,0.000330617931959726,0,"0"
"371830528062038","1","1","2","4","5","3","3","11","4","8","15",156,0.02013103663265,7749.22836050021,"43"
"371830541131012","1","1","1","3","4","3","2","9","5","8","14",0,0.00261350434987713,0,"0"
"371830541052003","2","3","2","7","2","3","3","8","3","10","11",1,0.00230447441511601,433.93842580355,"1"
"371830545002062","1","2","3","6","1","2","3","6","2","8","8",0,0.0421154184390684,0,"0"
"371830527061024","3","3","3","9","3","3","4","10","2","11","12",31,0.00873233892222025,3550.02253990825,"12"
"371830538082010","2","1","2","5","2","1","2","5","3","8","8",72,0.025877489298782,2782.34102113565,"23"
"371830538082022","2","4","3","9","2","4","3","9","5","14","14",52,0.046597453588042,1115.94080783299,"21"
"371830537251029","4","5","3","12","4","5","3","12","4","16","16",15,0.00208431399589039,7196.61242479552,"4"
"371830537192008","1","1","1","3","3","1","1","5","1","4","6",71,0.0129368892036216,5488.1818095902,"21"
"371830537171000","2","5","1","8","2","5","2","9","2","10","11",0,0.00983043763275986,0,"0"
"371830537252020","3","5","2","10","3","5","2","10","3","13","13",8,0.00278585225947543,2871.65264158925,"3"
"371830540181023","3","3","3","9","3","3","4","10","2","11","12",0,0.0206101166380999,0,"0"
"371830540132000","5","5","2","12","5","5","3","13","5","17","18",0,0.0278768556016872,0,"0"
"371830540111000","2","5","3","10","2","5","3","10","4","14","14",45,0.0494316782829545,910.347403994927,"20"
"371830527011008","3","3","4","10","3","3","4","10","2","12","12",55,0.0184082783743112,2987.78619497371,"25"
"371830525072016","2","2","2","6","2","2","2","6","4","10","10",51,0.0380683229778579,1339.69652484203,"21"
"371830537151003","5","5","4","14","5","5","4","14","5","19","19",211,0.019983200694554,10558.8690833448,"105"
"371830537262021","2","5","2","9","2","5","2","9","3","12","12",0,0.0120183460879208,0,"0"
"371830540013007","5","3","4","12","5","4","4","13","3","15","16",47,0.00854122042880129,5502.7265004793,"35"
"371830540171024","2","4","3","9","2","4","3","9","2","11","11",26,0.00224237104708808,11594.8696509275,"15"
"371830541041005","3","4","1","8","3","4","2","9","5","13","14",86,0.00879140382867672,9782.28297504389,"39"
"371830537072018","5","2","3","10","5","3","4","12","5","15","17",417,0.10592511793172,3936.74331586583,"189"
"371830540171053","1","2","2","5","1","2","2","5","2","7","7",0,0.00182343731328829,0,"0"
"371830540141079","1","3","2","6","1","3","2","6","3","9","9",0,5.39945423766013e-05,0,"0"
"371830509001010","5","5","5","15","5","5","5","15","5","20","20",91,0.00270997721067807,33579.6181759148,"20"
"371830509001011","5","5","5","15","5","5","5","15","5","20","20",64,0.00286877633224732,22309.1634159796,"31"
"371830540121005","1","4","3","8","1","4","3","8","3","11","11",203,0.224332862104112,904.90531835585,"85"
"371830541061039","1","3","4","8","2","3","5","10","4","12","14",0,5.74406543547147e-05,0,"0"
"371830526011014","3","3","3","9","5","3","4","12","4","13","16",127,0.0476315048534526,2666.3024901426,"52"
"371830510002017","5","5","5","15","5","5","5","15","5","20","20",62,0.00891715782550799,6952.88804047471,"30"
"371830510001004","4","5","5","14","4","5","5","14","4","18","18",179,0.00913121443494266,19603.0879874002,"133"
"371830510002004","5","5","5","15","5","5","5","15","5","20","20",63,0.00678956221700932,9278.94877259854,"33"
"371830503002007","4","5","5","14","5","5","5","15","3","17","18",9,0.00606848911485917,1483.07096373672,"8"
"371830540171033","2","3","3","8","2","3","3","8","2","10","10",461,0.00450703742629355,102284.484550889,"241"
"371830521011033","2","2","3","7","2","2","4","8","2","9","10",42,0.00161379728375393,26025.5736100273,"13"
"371830523011019","3","5","3","11","3","5","3","11","3","14","14",53,0.00392558205055347,13501.1825806895,"34"
"371830545002014","4","4","4","12","4","4","5","13","4","16","17",0,0.00123318438173058,0,"0"
"371830545003030","2","2","3","7","2","2","3","7","3","10","10",30,0.00193904258909902,15471.5529038171,"13"
"371830524011010","1","5","1","7","1","5","1","7","3","10","10",0,0.00810213570310331,0,"0"
"371830537162004","2","3","3","8","3","3","4","10","3","11","13",202,0.129576668214272,1558.92262691896,"86"
"371830537091007","1","5","2","8","1","5","2","8","3","11","11",103,0.00894536731170002,11514.3399271355,"52"
"371830537093035","1","5","1","7","1","5","1","7","2","9","9",26,0.00758861403716511,3426.18558180261,"15"
"371830537092015","2","5","2","9","2","5","2","9","3","12","12",37,0.00500180760230545,7397.32571539654,"24"
"371830537092009","1","5","2","8","1","5","2","8","3","11","11",105,0.00640392997616892,16396.1817806782,"59"
"371830525042001","5","5","4","14","5","5","5","15","5","19","20",128,0.024132767837599,5303.99168721024,"81"
"371830540171049","3","5","3","11","3","5","3","11","2","13","13",0,0.00505869123959273,0,"0"
"371830501001098","5","5","5","15","5","5","5","15","5","20","20",196,0.00474764494094022,41283.6263954449,"127"
"371830540141064","3","4","2","9","3","5","3","11","3","12","14",0,0.000866810761204498,0,"0"
"371830538071007","4","2","3","9","4","2","3","9","3","12","12",1,0.00841661599787784,118.812596446379,"1"
"371830538082025","2","1","2","5","2","2","3","7","3","8","10",4,0.0075369191065198,530.72083479572,"1"
"371839802001013","1","5","1","7","1","5","1","7","2","9","9",0,0.45690235462336,0,"0"
"371830528061016","1","2","2","5","3","3","3","9","3","8","12",0,3.3390255701932e-05,0,"0"
"371830537111028","1","5","1","7","1","5","1","7","2","9","9",38,0.0276542964000344,1374.108364585,"13"
"371830528064030","1","1","1","3","1","2","1","4","4","7","8",170,0.0132142855875617,12864.864988238,"56"
"371830537241020","2","5","1","8","2","5","2","9","2","10","11",35,0.00869966821491438,4023.14193315986,"10"
"371830537171024","1","5","1","7","4","5","2","11","1","8","12",0,0.00336273955419157,0,"0"
"371830537251003","5","5","3","13","5","5","3","13","4","17","17",0,7.80925868332268e-05,0,"0"
"371839802001000","4","5","2","11","4","5","2","11","2","13","13",0,0.0386027295154599,0,"0"
"371830540132030","1","4","1","6","1","5","2","8","5","11","13",0,0.000680877662633485,0,"0"
"371830540181036","3","4","4","11","3","4","4","11","2","13","13",23,0.0485548372406573,473.691218158198,"11"
"371830540132025","2","4","1","7","2","5","2","9","4","11","13",0,0.0011499616335747,0,"0"
"371830540132021","2","5","1","8","2","5","2","9","4","12","13",55,0.00662425643242161,8302.81867272064,"20"
"371830540131013","1","5","1","7","1","5","2","8","4","11","12",164,0.0141686183385016,11574.8759746283,"65"
"371830540141095","4","3","2","9","4","4","2","10","4","13","14",96,0.00771226945305309,12447.6978643421,"29"
"371830514003007","5","5","5","15","5","5","5","15","5","20","20",48,0.0137590369345469,3488.61626204949,"20"
"371830540133007","1","4","1","6","1","4","1","6","5","11","11",108,0.011613315024856,9299.67022928827,"50"
"371830540143022","2","3","2","7","2","4","3","9","2","9","11",0,0.00637094200254016,0,"0"
"371830541041030","2","3","2","7","2","4","3","9","3","10","12",0,0.00319698737827836,0,"0"
"371830507003012","5","4","5","14","5","4","5","14","4","18","18",15,0.00682685840470573,2197.20391295366,"8"
"371830516005000","4","4","5","13","5","4","5","14","3","16","17",49,0.00901976929893968,5432.51145079289,"22"
"371830512002011","5","5","5","15","5","5","5","15","4","19","19",20,0.00585236530048883,3417.42167023126,"14"
"371830540122005","4","5","4","13","4","5","4","13","2","15","15",104,0.0804384490843408,1292.91403779994,"37"
"371830503002001","5","5","5","15","5","5","5","15","3","18","18",119,0.00797951486986586,14913.187322878,"79"
"371830525031001","1","1","1","3","1","1","1","3","3","6","6",303,0.126379976982539,2397.53169160542,"69"
"371830512003011","5","5","5","15","5","5","5","15","4","19","19",49,0.00435887330841046,11241.4370716979,"17"
"371830510001010","5","5","5","15","5","5","5","15","5","20","20",37,0.00658986619694744,5614.68152678717,"19"
"371830525043040","4","5","3","12","4","5","4","13","3","15","16",31,0.0368193155069611,841.949383717878,"19"
"371830510001006","4","5","5","14","4","5","5","14","4","18","18",237,0.010532757449293,22501.2301993063,"197"
"371830527061003","2","3","3","8","2","3","4","9","2","10","11",0,0.00201137796123739,0,"0"
"371830524071010","4","4","4","12","4","4","5","13","4","16","17",0,0.002962282418918,0,"0"
"371830541062030","3","2","4","9","3","3","4","10","3","12","13",0,0.0189195892404381,0,"0"
"371830540041008","5","4","4","13","5","4","4","13","2","15","15",321,0.0723493381351871,4436.80631051802,"150"
"371830519002020","4","4","5","13","4","4","5","13","3","16","16",28,0.0059451986912753,4709.68279682403,"12"
"371830501001006","4","5","5","14","4","5","5","14","4","18","18",0,0.0263075668355827,0,"0"
"371830501001065","5","5","5","15","5","5","5","15","5","20","20",0,0.00519635338199575,0,"0"
"371830515012022","3","3","4","10","3","3","5","11","4","14","15",33,0.0116901678114163,2822.88505454757,"10"
"371830515012005","3","3","4","10","3","3","5","11","4","14","15",29,0.00959945582627038,3021.00457826339,"12"
"371830511022004","3","5","5","13","3","5","5","13","5","18","18",0,0.00337372626936645,0,"0"
"371830545003024","3","5","4","12","3","5","4","12","3","15","15",14,0.00133717086418056,10469.8661741927,"12"
"371830545002023","4","5","5","14","4","5","5","14","5","19","19",0,0.000171204730999347,0,"0"
"371830540123000","3","4","4","11","3","4","4","11","2","13","13",39,0.0225231920385936,1731.54852709924,"24"
"371830540141096","3","3","1","7","3","4","2","9","4","11","13",109,0.00931119458615819,11706.3389655756,"35"
"371830540132056","1","5","2","8","1","5","2","8","4","12","12",4,0.00258590349272419,1546.84813692954,"1"
"371830518001006","2","3","4","9","3","3","5","11","5","14","16",0,0.00919405438844427,0,"0"
"371830520011004","2","3","4","9","5","4","5","14","4","13","18",0,0.00381591079940479,0,"0"
"371830506002021","5","4","5","14","5","4","5","14","3","17","17",44,0.0050007796505387,8798.62802898347,"17"
"371830519001044","4","4","5","13","4","4","5","13","3","16","16",0,0.000957568398627167,0,"0"
"371830520021008","5","4","4","13","5","4","5","14","5","18","19",40,0.00757242339094309,5282.32481662892,"15"
"371830519001025","3","4","4","11","5","4","5","14","4","15","18",11,0.013760004838137,799.41832356865,"5"
"371830526023003","4","3","4","11","4","3","4","11","3","14","14",83,0.0183540118354716,4522.17208662748,"36"
"371830526021022","3","2","4","9","3","2","4","9","2","11","11",55,0.0144428609692702,3808.10977250437,"26"
"371830527051003","4","3","4","11","4","3","4","11","2","13","13",21,0.00426851469126628,4919.7441074685,"9"
"371830527012032","2","2","4","8","2","2","4","8","3","11","11",58,0.0107213265077645,5409.77834766956,"21"
"371830541102046","3","2","1","6","3","3","2","8","4","10","12",65,0.00634876162811431,10238.2171212981,"21"
"371830509002005","4","5","5","14","4","5","5","14","5","19","19",0,0.0108993916406599,0,"0"
"371830524071028","4","5","4","13","4","5","4","13","3","16","16",37,0.0135369089771528,2733.26799067996,"18"
"371830524041002","4","5","4","13","4","5","5","14","3","16","17",11,0.0153257562959729,717.745981833891,"6"
"371830511012017","4","5","4","13","4","5","5","14","4","17","18",73,0.00905139546469091,8065.05475147669,"19"
"371830528031021","2","2","3","7","2","2","3","7","2","9","9",0,7.6567988611097e-05,0,"0"
"371830521012013","5","4","5","14","5","4","5","14","3","17","17",58,0.0117119474323018,4952.20801965307,"22"
"371830537143000","2","2","3","7","2","2","3","7","3","10","10",0,0.00187069640075078,0,"0"
"371830537092013","1","5","2","8","1","5","2","8","3","11","11",90,0.00561271418111502,16035.0228242195,"51"
"371830540061011","3","2","3","8","3","2","3","8","4","12","12",192,0.026357484244708,7284.45849449949,"91"
"371830538082000","1","1","1","3","1","1","1","3","3","6","6",0,0.0220853862923123,0,"0"
"371830538082004","1","1","2","4","4","1","3","8","4","8","12",61,0.0210190020796942,2902.13587537204,"21"
"371830501001109","5","5","5","15","5","5","5","15","5","20","20",0,0.00843366143736693,0,"0"
"371830536101024","1","1","1","3","1","1","1","3","1","4","4",29,0.00222053863152037,13059.8943825373,"13"
"371839801001000","1","5","1","7","1","5","1","7","1","8","8",0,0.00513762564871852,0,"0"
"371830537113006","4","5","3","12","4","5","3","12","4","16","16",0,0.00262664480963474,0,"0"
"371830537241036","2","5","2","9","2","5","2","9","2","11","11",71,0.00624720614155349,11365.080388134,"44"
"371830537241051","2","5","2","9","2","5","2","9","2","11","11",0,0.00570782275088808,0,"0"
"371830537241019","2","5","1","8","2","5","1","8","2","10","10",0,0.00386061463949444,0,"0"
"371830537132012","2","2","3","7","2","2","3","7","4","11","11",210,0.0190618256435419,11016.7831731872,"117"
"371830540123007","4","4","4","12","4","4","4","12","2","14","14",64,0.0207045180573434,3091.11276209111,"24"
"371830540081006","5","4","3","12","5","4","3","12","2","14","14",57,0.0116403386094357,4896.76476883549,"21"
"371830540162002","2","3","2","7","2","4","2","8","3","10","11",0,0.00370046528723416,0,"0"
"371830527043020","4","3","4","11","4","3","4","11","2","13","13",188,0.0234698478500737,8010.27774875027,"77"
"371830541042003","5","5","3","13","5","5","3","13","4","17","17",7,0.00223465410881673,3132.47583703528,"1"
"371830540131023","2","5","2","9","2","5","2","9","5","14","14",0,0.000424046389315892,0,"0"
"371830515022008","5","3","4","12","5","3","5","13","4","16","17",100,0.0210965439033078,4740.11290466968,"48"
"371830506003007","5","5","5","15","5","5","5","15","5","20","20",42,0.00833765111388094,5037.38995867509,"20"
"371830509001017","5","5","5","15","5","5","5","15","5","20","20",105,0.00951864212312432,11030.9851596286,"43"
"371830509003010","5","5","5","15","5","5","5","15","5","20","20",57,0.00490590616696904,11618.6486369786,"18"
"371830514004000","4","5","5","14","4","5","5","14","4","18","18",65,0.0135366166489865,4801.79070483368,"33"
"371830540072013","3","1","2","6","3","1","3","7","4","10","11",419,0.0474730643089816,8826.05759916635,"222"
"371830525051008","2","2","3","7","2","2","3","7","5","12","12",34,0.00535928212990335,6344.13325812597,"24"
"371830510001000","5","5","5","15","5","5","5","15","4","19","19",0,0.00251048625372627,0,"0"
"371830501001087","5","5","5","15","5","5","5","15","5","20","20",2,0.00842030007159899,237.521226440117,"1"
"371830510002024","5","5","5","15","5","5","5","15","5","20","20",72,0.01078697964646,6674.71362325489,"23"
"371830545001011","5","5","5","15","5","5","5","15","4","19","19",10,0.00498547820504375,2005.82563772581,"3"
"371830545001024","5","5","5","15","5","5","5","15","4","19","19",40,0.00674960557971469,5926.27221362627,"16"
"371830509002006","5","5","5","15","5","5","5","15","5","20","20",211,0.0240521984227594,8772.5868667515,"59"
"371830501001114","5","5","5","15","5","5","5","15","4","19","19",0,0.00890472884665616,0,"0"
"371830501001111","5","5","5","15","5","5","5","15","5","20","20",0,0.0044286769930401,0,"0"
"371830540072000","1","3","3","7","2","3","3","8","5","12","13",77,0.0219544724291484,3507.25804268332,"45"
"371830545001041","5","5","5","15","5","5","5","15","5","20","20",0,0.00135271514403012,0,"0"
"371830537241086","1","5","2","8","1","5","2","8","3","11","11",350,0.0225858765662794,15496.4098459012,"158"
"371830521014020","4","5","5","14","4","5","5","14","5","19","19",17,0.00683204777361305,2488.27299856683,"11"
"371830520012024","3","4","5","12","5","5","5","15","4","16","19",51,0.00698679956804635,7299.47946886082,"17"
"371830526021018","3","2","4","9","3","2","4","9","3","12","12",36,0.0108018105110764,3332.77462727983,"18"
"371830527061022","4","3","3","10","4","3","4","11","3","13","14",0,0.00178905018380571,0,"0"
"371830541063032","3","3","2","8","3","3","2","8","4","12","12",0,0.000663588240483204,0,"0"
"371830528063007","5","2","2","9","5","2","3","10","4","13","14",0,0.0109050032361968,0,"0"
"371830545003033","1","2","3","6","1","2","3","6","3","9","9",4,0.000358348515806534,11162.3177537019,"2"
"371830537142005","2","3","3","8","2","3","3","8","3","11","11",0,0.0246483558692028,0,"0"
"371830537222005","3","2","3","8","3","2","3","8","3","11","11",70,0.0184889040708374,3786.05458343045,"25"
"371830537142009","3","3","3","9","3","3","3","9","4","13","13",0,0.000170091740972881,0,"0"
"371830537241010","2","5","1","8","2","5","2","9","2","10","11",0,0.0166633660445322,0,"0"
"371830537112019","3","5","2","10","3","5","2","10","4","14","14",0,0.00342908869864015,0,"0"
"371830537122002","3","2","2","7","3","2","2","7","3","10","10",91,0.0138502101935303,6570.29739826679,"64"
"371830540141063","3","2","1","6","3","3","2","8","5","11","13",128,0.0107729180428493,11881.6461325409,"36"
"371830527011019","5","3","4","12","5","3","5","13","3","15","16",32,0.0085839206092353,3727.90027502954,"12"
"371830540141015","3","2","1","6","3","3","2","8","5","11","13",71,0.00679564760956717,10447.863703239,"25"
"371830540141026","2","2","1","5","2","3","2","7","4","9","11",216,0.0204254749531635,10575.029491128,"61"
"371830503001022","5","5","5","15","5","5","5","15","3","18","18",3,0.000614209850371963,4884.32414130645,"3"
"371830524011075","3","5","4","12","3","5","4","12","3","15","15",0,0.00807020555040904,0,"0"
"371830524072003","4","5","4","13","5","5","4","14","3","16","17",27,0.0104753894204127,2577.46981199447,"13"
"371830505003021","5","5","5","15","5","5","5","15","4","19","19",19,0.00931283564074535,2040.19492375357,"10"
"371830527052032","2","2","4","8","2","3","5","10","5","13","15",0,0.00461325153415405,0,"0"
"371830524071027","4","5","3","12","4","5","4","13","3","15","16",127,0.0619001732441134,2051.69054211133,"55"
"371830542091079","3","2","1","6","3","3","1","7","3","9","10",54,0.00580586815767868,9300.93459469642,"24"
"371830510001003","4","5","5","14","4","5","5","14","4","18","18",79,0.00620169432678555,12738.4543380014,"58"
"371830540143023","2","3","2","7","2","4","3","9","2","9","11",0,0.00475575513351512,0,"0"
"371830540143015","2","2","2","6","2","3","2","7","2","8","9",21,0.00508470996882971,4130.02907318888,"6"
"371830540131001","2","5","1","8","2","5","1","8","4","12","12",0,0.000342256436326558,0,"0"
"371830527043000","3","4","4","11","3","4","4","11","2","13","13",3,0.0361297083940014,83.034160344845,"1"
"371830541041048","2","3","2","7","2","4","3","9","3","10","12",0,0.00032214921581557,0,"0"
"371830507003010","5","4","5","14","5","5","5","15","4","18","19",36,0.00310960932179757,11577.01700585,"13"
"371830540141071","4","3","1","8","4","4","2","10","5","13","15",7,0.0999565801227012,70.030407116842,"5"
"371830526011008","3","4","3","10","3","4","4","11","5","15","16",57,0.0160282064234607,3556.23071565688,"23"
"371830526011029","4","3","3","10","4","3","4","11","4","14","15",34,0.00932954718206167,3644.3355005882,"13"
"371830512002015","4","5","5","14","5","5","5","15","4","18","19",105,0.00779276855335458,13474.0303502021,"39"
"371830503002011","4","5","5","14","4","5","5","14","4","18","18",21,0.00478188037374542,4391.57786449427,"17"
"371830503002019","4","5","5","14","4","5","5","14","4","18","18",20,0.00753437604829793,2654.49983804805,"12"
"371830509002028","3","5","5","13","3","5","5","13","4","17","17",0,0.00506022327017562,0,"0"
"371830501001113","5","5","5","15","5","5","5","15","5","20","20",105,0.00858070741124886,12236.7533313571,"68"
"371830526011016","3","4","4","11","3","4","4","11","4","15","15",46,0.0129013303713721,3565.52376195817,"17"
"371830509003002","5","5","5","15","5","5","5","15","5","20","20",0,0.00115295134874947,0,"0"
"371830527071004","3","4","3","10","3","4","4","11","2","12","13",26,0.00624509445908328,4163.26769280229,"7"
"371830541054002","3","3","2","8","3","3","3","9","3","11","12",41,0.0659062153226856,622.096107313377,"19"
"371830541055003","3","3","2","8","3","3","3","9","5","13","14",19,0.00262799841028049,7229.83694574309,"12"
"371830523021025","3","5","4","12","3","5","4","12","5","17","17",0,0.000372532834919984,0,"0"
"371830541103036","1","1","1","3","5","2","2","9","2","5","11",8,0.0147800425242176,541.270431860511,"4"
"371830542081089","1","4","1","6","1","5","1","7","2","8","9",32,0.000318240881516791,100552.763200889,"20"
"371830516004016","5","4","5","14","5","4","5","14","3","17","17",27,0.00819391102196765,3295.12975276565,"11"
"371830514002004","5","5","5","15","5","5","5","15","4","19","19",73,0.0120449358058133,6060.63836095896,"31"
"371830530081032","2","4","2","8","2","4","2","8","3","11","11",64,0.000913683555924924,70046.1331332735,"31"
"371830511022002","4","5","5","14","4","5","5","14","5","19","19",0,0.0287300593798498,0,"0"
"371830506003018","5","5","5","15","5","5","5","15","5","20","20",35,0.00432074686472767,8100.4514024466,"15"
"371830537112028","4","5","3","12","4","5","3","12","5","17","17",155,0.0371590872626588,4171.25423195633,"48"
"371830506003015","5","5","5","15","5","5","5","15","4","19","19",24,0.0042347202202716,5667.43462416054,"12"
"371830530031078","1","3","2","6","1","3","2","6","3","9","9",0,0.00172270856436575,0,"0"
"371830523013012","3","5","3","11","3","5","4","12","3","14","15",13,0.0089255501332787,1456.4928554409,"3"
"371830530081048","2","4","2","8","2","4","2","8","3","11","11",0,0.00405381284627294,0,"0"
"371830545003026","1","4","3","8","1","4","3","8","3","11","11",27,0.060251018893744,448.125201793118,"3"
"371830545004005","3","4","4","11","3","4","4","11","3","14","14",58,0.0216644656261558,2677.19504375755,"29"
"371830523023007","3","5","3","11","3","5","3","11","3","14","14",54,0.00116594981445146,46314.1717856915,"19"
"371830536101037","2","1","1","4","2","1","1","4","1","5","5",9,0.000879815482838938,10229.4176171569,"4"
"371830536101044","2","1","1","4","2","1","1","4","1","5","5",5,0.00151978903168973,3289.93030989368,"2"
"371830508001001","5","5","5","15","5","5","5","15","4","19","19",70,0.00385786993560378,18144.72783387,"20"
"371830536101066","4","1","1","6","4","1","1","6","1","7","7",51,0.00259387501316961,19661.7029506291,"24"
"371830540131045","3","5","3","11","3","5","3","11","5","16","16",128,0.0059974428279119,21342.4293774494,"72"
"371830527011007","4","2","4","10","4","3","4","11","2","12","13",80,0.0193464389340972,4135.12793090845,"28"
"371830515011018","3","3","4","10","3","3","4","10","4","14","14",0,0.00392806952159938,0,"0"
"371830530081008","3","5","3","11","3","5","3","11","4","15","15",0,0.00322432318212146,0,"0"
"371830524063012","1","2","2","5","4","2","2","8","2","7","10",30,0.00875397480913924,3427.01465952126,"15"
"371830526032018","3","3","4","10","3","3","5","11","4","14","15",0,0.0132497433739375,0,"0"
"371830540131035","2","5","2","9","2","5","2","9","4","13","13",102,0.0884440913561385,1153.27093575167,"32"
"371830523021010","3","5","4","12","3","5","4","12","4","16","16",67,0.00237166886287748,28250.1495249682,"29"
"371830511021002","5","5","5","15","5","5","5","15","4","19","19",0,0.000636281998373989,0,"0"
"371830504001018","3","5","5","13","5","5","5","15","3","16","18",4,0.00692920326512516,577.266944979388,"2"
"371830528072022","3","2","2","7","3","3","2","8","3","10","11",45,0.00413291032019412,10888.2110942795,"12"
"371830528062047","3","2","2","7","3","4","3","10","4","11","14",9,0.00267656432609863,3362.51959732215,"3"
"371830524081014","4","5","4","13","4","5","5","14","4","17","18",69,0.0152131265414765,4535.55683060158,"25"
"371830541043031","2","3","3","8","4","4","3","11","3","11","14",126,0.0293081721076309,4299.14221662407,"39"
"371830519002010","4","4","5","13","4","4","5","13","4","17","17",52,0.00886273394113583,5867.26402319776,"25"
"371830519003002","5","2","4","11","5","2","5","12","5","16","17",44,0.00945592636864813,4653.16652061563,"21"
"371830525031008","2","5","2","9","2","5","2","9","3","12","12",171,0.0338568498533876,5050.67662055069,"132"
"371830519001013","4","4","5","13","5","4","5","14","4","17","18",0,0.000976190903829312,0,"0"
"371830524063010","1","2","2","5","3","2","2","7","2","7","9",46,0.00505547918009451,9099.03856020628,"27"
"371830515012027","4","5","4","13","4","5","5","14","5","18","19",0,0.00658052459473451,0,"0"
"371830521021024","1","2","3","6","1","3","4","8","3","9","11",0,0.00611267875834647,0,"0"
"371830523021026","2","5","4","11","2","5","4","11","4","15","15",0,0.00585577327591827,0,"0"
"371830523023003","3","5","3","11","5","5","4","14","3","14","17",53,0.00308257121939808,17193.4389273735,"25"
"371830523011023","5","5","3","13","5","5","4","14","5","18","19",0,0.00219970172558917,0,"0"
"371830518001019","5","4","5","14","5","4","5","14","3","17","17",49,0.0106209665002729,4613.51610503067,"28"
"371830523023013","2","5","3","10","3","5","3","11","3","13","14",204,0.00635699136782949,32090.6523536232,"53"
"371830537093011","2","5","1","8","2","5","1","8","2","10","10",32,0.00885254279581493,3614.78060463352,"10"
"371830537241009","1","5","1","7","1","5","1","7","1","8","8",0,0.00829583423345848,0,"0"
"371830536102050","3","5","1","9","3","5","2","10","1","10","11",0,0.00763202442308823,0,"0"
"371830537252005","3","5","2","10","3","5","2","10","3","13","13",4,0.00367076192189021,1089.69202719098,"1"
"371830537122009","2","2","2","6","2","2","2","6","3","9","9",0,0.0024564623527982,0,"0"
"371830537151007","4","4","4","12","4","4","4","12","5","17","17",53,0.0116022219640893,4568.09050577066,"21"
"371830537252022","4","5","2","11","4","5","2","11","3","14","14",0,0.00148744273629199,0,"0"
"371830517002005","3","4","4","11","5","5","5","15","4","15","19",26,0.0128413093665828,2024.71564680627,"11"
"371830537241025","2","5","1","8","2","5","2","9","2","10","11",303,0.0424784001131631,7133.03700687417,"144"
"371830537132010","3","2","2","7","3","2","3","8","4","11","12",105,0.00558927759928475,18785.9697670834,"47"
"371830527012017","2","3","4","9","2","3","4","9","2","11","11",0,0.000332680921239788,0,"0"
"371830541042004","5","5","3","13","5","5","3","13","4","17","17",109,0.0100063283099235,10893.1065046009,"27"
"371830540081007","4","4","3","11","4","4","3","11","2","13","13",25,0.00209828266850174,11914.5053120279,"15"
"371830540141066","3","3","1","7","3","4","2","9","4","11","13",1,0.025745026918182,38.8424530756178,"1"
"371830506002009","5","4","5","14","5","5","5","15","4","18","19",19,0.00314256342023259,6046.0195895088,"9"
"371830507002001","5","5","5","15","5","5","5","15","4","19","19",36,0.0065688286617032,5480.42913798055,"17"
"371830506002015","5","4","5","14","5","5","5","15","4","18","19",38,0.0042320286714802,8979.14521611904,"16"
"371830507003026","5","5","5","15","5","5","5","15","4","19","19",13,0.00240420052903212,5407.20286973464,"6"
"371830507001021","5","5","5","15","5","5","5","15","5","20","20",41,0.00505000136113899,8118.80969290526,"13"
"371830537152004","3","3","3","9","3","3","3","9","4","13","13",21,0.0326823737043835,642.548187899319,"13"
"371830537221003","2","2","2","6","2","2","2","6","3","9","9",254,0.049384505195352,5143.31365668732,"160"
"371830515022004","5","3","4","12","5","3","5","13","3","15","16",47,0.0132669057484462,3542.64972489947,"27"
"371830537093026","1","5","2","8","1","5","2","8","3","11","11",19,0.022427948169312,847.157299302018,"11"
"371830520022012","5","4","5","14","5","4","5","14","5","19","19",64,0.0106636912630288,6001.67413153542,"16"
"371830521014002","4","4","5","13","4","4","5","13","5","18","18",0,0.00446558165780181,0,"0"
"371830526022001","4","3","4","11","4","3","4","11","3","14","14",145,0.0375655719406304,3859.91727289981,"53"
"371830526032008","4","3","4","11","4","3","5","12","5","16","17",218,0.0548631261689259,3973.52493783837,"81"
"371830517001008","5","4","5","14","5","4","5","14","4","18","18",50,0.0114396911766164,4370.74735917731,"17"
"371830511022005","3","5","5","13","3","5","5","13","5","18","18",0,0.0023816663319952,0,"0"
"371830527071007","3","3","3","9","3","3","4","10","2","11","12",25,0.00692059095121103,3612.40827210359,"10"
"371830541051003","1","1","1","3","1","1","2","4","3","6","7",49,0.0054671021838787,8962.70059566298,"18"
"371830505003024","4","4","5","13","4","4","5","13","5","18","18",0,0.000399213121740763,0,"0"
"371830542071043","2","4","1","7","2","4","1","7","2","9","9",158,0.0223737293571231,7061.85354609637,"51"
"371830537121008","2","1","2","5","2","1","2","5","3","8","8",85,0.0389802897546743,2180.589229453,"35"
"371830537113008","4","5","3","12","4","5","3","12","4","16","16",1,0.00596937562418985,167.521707956805,"1"
"371830537171007","1","5","1","7","1","5","1","7","2","9","9",66,0.00994738175367096,6634.91174204142,"24"
"371830537113017","3","5","3","11","3","5","3","11","5","16","16",57,0.00468249022724792,12173.0099228634,"34"
"371830527052023","2","2","4","8","2","2","5","9","4","12","13",0,0.00493798038489184,0,"0"
"371830540082014","3","3","3","9","3","4","4","11","2","11","13",70,0.00646775622560237,10822.9187307505,"44"
"371830540141032","2","2","1","5","2","3","2","7","4","9","11",106,0.00435879070055406,24318.6716872012,"43"
"371830540111014","2","3","2","7","2","3","3","8","3","10","11",1,0.000288967118343566,3460.60135053516,"1"
"371830540134042","2","5","2","9","2","5","2","9","5","14","14",0,0.00354614766761236,0,"0"
"371830527052007","5","3","4","12","5","3","5","13","3","15","16",0,0.0314393162919558,0,"0"
"371830518002019","5","4","5","14","5","4","5","14","3","17","17",42,0.00602690214339245,6968.75426226165,"19"
"371830519001045","4","4","5","13","4","4","5","13","3","16","16",0,0.00264297126636374,0,"0"
"371830519001031","3","4","5","12","4","4","5","13","3","15","16",0,0.00130750271068776,0,"0"
"371830520012017","4","4","5","13","5","4","5","14","3","16","17",23,0.00691206972313404,3327.51273081364,"7"
"371830510001017","4","5","5","14","5","5","5","15","4","18","19",19,0.00124201544032334,15297.7164237618,"15"
"371830511011006","3","5","5","13","3","5","5","13","5","18","18",0,0.00223800026895345,0,"0"
"371830520024011","3","4","5","12","5","5","5","15","4","16","19",33,0.00552645914048842,5971.27367833638,"10"
"371830520012026","2","4","4","10","5","5","5","15","4","14","19",0,0.00368845452990804,0,"0"
"371830541052026","3","3","2","8","3","3","3","9","4","12","13",46,0.0195397556323782,2354.17478424224,"22"
"371830541103022","1","1","1","3","4","1","1","6","2","5","8",69,0.0243073212919076,2838.6509221389,"27"
"371830542071075","2","4","1","7","2","4","1","7","2","9","9",59,0.0111965007366605,5269.5035161135,"16"
"371830524011005","2","5","2","9","2","5","2","9","3","12","12",0,0.0177564636225653,0,"0"
"371830537181002","1","1","1","3","4","1","1","6","1","4","7",113,0.0105355444625969,10725.5966126071,"27"
"371830526031014","4","3","4","11","4","3","5","12","5","16","17",102,0.0301708835460814,3380.74288889189,"36"
"371830516001007","3","4","4","11","5","4","5","14","3","14","17",24,0.0102913930693828,2332.04580159324,"9"
"371830517001004","5","4","4","13","5","4","5","14","5","18","19",54,0.012112996777155,4458.02149488255,"17"
"371830528021000","1","5","3","9","1","5","3","9","3","12","12",0,0.00487849270640992,0,"0"
"371830528033044","1","1","3","5","1","2","3","6","2","7","8",0,0.0105387259110451,0,"0"
"371830527052004","5","3","4","12","5","3","4","12","2","14","14",156,0.0258650985948681,6031.2934600973,"51"
"371830530081052","1","4","2","7","1","4","2","7","3","10","10",51,0.00505791730835701,10083.2016205039,"30"
"371830536102014","3","5","1","9","3","5","2","10","1","10","11",0,0.00183623392033308,0,"0"
"371830536102035","5","5","2","12","5","5","2","12","1","13","13",0,0.000440696129131125,0,"0"
"371830527012020","3","3","4","10","3","3","4","10","3","13","13",0,0.0318935192738276,0,"0"
"371830527043001","3","3","3","9","3","3","4","10","2","11","12",48,0.0312633789969877,1535.3426769584,"25"
"371830527043007","5","3","4","12","5","3","4","12","2","14","14",60,0.0103723349923137,5784.61841470241,"21"
"371830511023011","5","5","5","15","5","5","5","15","5","20","20",0,0.00091190064395805,0,"0"
"371830514005020","5","5","5","15","5","5","5","15","3","18","18",45,0.00995965236245473,4518.22999060069,"16"
"371830504001010","3","4","5","12","4","4","5","13","4","16","17",0,0.00433689719930742,0,"0"
"371830541052027","2","4","3","9","2","4","4","10","2","11","12",260,0.115266143985224,2255.64932607904,"118"
"371830505001017","5","4","5","14","5","5","5","15","3","17","18",16,0.00316880637278767,5049.21983791785,"12"
"371830516001000","2","4","4","10","4","4","5","13","3","13","16",0,0.00220484885667304,0,"0"
"371830545001000","4","5","5","14","4","5","5","14","4","18","18",0,0.0027638085611598,0,"0"
"371830516002015","5","4","4","13","5","4","5","14","3","16","17",47,0.0153598293315607,3059.92983290684,"17"
"371830526012011","2","3","4","9","2","3","5","10","3","12","13",0,0.0125395403475828,0,"0"
"371830541044021","3","4","3","10","3","4","3","10","3","13","13",45,0.00651370032638471,6908.51555109479,"11"
"371830537151008","5","5","3","13","5","5","3","13","5","18","18",19,0.00563707119900182,3370.54461958267,"9"
"371830541062003","1","3","3","7","1","3","4","8","2","9","10",0,0.0105362675683841,0,"0"
"371830541042019","4","5","3","12","4","5","3","12","4","16","16",24,0.0271320940578952,884.561285567866,"8"
"371830541102024","1","2","1","4","1","2","2","5","3","7","8",31,0.000625559346957169,49555.6499168136,"5"
"371830541102008","1","1","1","3","1","1","1","3","3","6","6",28,0.00305988026856693,9150.6848446438,"9"
"371830537152013","3","3","3","9","3","3","3","9","4","13","13",27,0.00700144726650259,3856.3455486093,"11"
"371830535211075","1","5","1","7","1","5","2","8","3","10","11",0,0.0358328244726153,0,"0"
"371830535211021","3","5","2","10","3","5","2","10","4","14","14",0,0.000322135046122117,0,"0"
"371830525072020","1","2","2","5","1","2","2","5","4","9","9",69,0.0216839341140091,3182.07939745685,"25"
"371830537162010","5","5","4","14","5","5","4","14","5","19","19",0,0.000963194535942051,0,"0"
"371830537142000","3","3","3","9","3","3","3","9","3","12","12",15,0.00177874897826657,8432.89310817643,"5"
"371830537142029","2","3","3","8","2","3","3","8","3","11","11",0,0.00141704403432109,0,"0"
"371830537071024","4","2","3","9","4","2","3","9","3","12","12",20,0.0106928750752415,1870.40434488087,"9"
"371830525051001","4","5","4","13","4","5","4","13","5","18","18",59,0.0173347035775225,3403.5770924,"23"
"371830518003016","4","4","5","13","4","4","5","13","4","17","17",45,0.0103704352021584,4339.25858681747,"23"
"371830527013022","3","3","4","10","3","3","5","11","5","15","16",0,0.0455701591779315,0,"0"
"371830537241042","3","5","2","10","3","5","2","10","2","12","12",11,0.0037370137851039,2943.52673887559,"5"
"371830537171004","3","5","2","10","3","5","2","10","2","12","12",0,0.0061976738724593,0,"0"
"371830537241040","3","5","2","10","3","5","2","10","2","12","12",48,0.00439819997170008,10913.5556156729,"24"
"371830537241049","2","5","2","9","2","5","2","9","2","11","11",0,0.00139155338885671,0,"0"
"371830537241015","1","5","1","7","1","5","2","8","2","9","10",111,0.0224638626020869,4941.26953882312,"29"
"371830537112027","5","3","3","11","5","3","3","11","5","16","16",17,0.00422048459113436,4027.97347861678,"7"
"371830540134019","1","3","1","5","1","4","1","6","5","10","11",80,0.013563129601816,5898.34369711315,"20"
"371830540081008","4","4","3","11","4","4","3","11","2","13","13",64,0.00424704450201074,15069.3028927998,"30"
"371830540132003","3","5","2","10","3","5","2","10","4","14","14",6,0.0144476135260217,415.293500839663,"5"
"371830540132051","2","4","1","7","2","5","2","9","4","11","13",0,0.000733959237522243,0,"0"
"371830540181029","4","4","4","12","4","4","4","12","2","14","14",154,0.00513948586732018,29964.0866762998,"79"
"371830516003008","4","4","5","13","4","4","5","13","3","16","16",31,0.011022083702699,2812.53534596267,"10"
"371830516004001","4","4","5","13","4","5","5","14","3","16","17",16,0.0050033932108435,3197.82981783729,"7"
"371830512003001","5","5","5","15","5","5","5","15","3","18","18",56,0.00596738022361014,9384.35258045635,"34"
"371830512002004","5","5","5","15","5","5","5","15","3","18","18",260,0.0264302963576404,9837.19578781189,"160"
"371830512002005","5","5","5","15","5","5","5","15","4","19","19",79,0.0195073584403592,4049.75385270798,"56"
"371830512002001","5","5","5","15","5","5","5","15","3","18","18",0,0.000437878163009012,0,"0"
"371830507003030","5","5","5","15","5","5","5","15","4","19","19",18,0.00261688758026837,6878.40017879333,"5"
"371830517002012","4","4","4","12","5","4","5","14","4","16","18",73,0.0205867238906041,3545.97459935417,"25"
"371830518002023","4","4","5","13","5","5","5","15","3","16","18",33,0.0153800610311984,2145.63517875902,"18"
"371830501001012","4","5","5","14","5","5","5","15","3","17","18",0,0.00211045382718654,0,"0"
"371830528063022","5","2","2","9","5","3","3","11","4","13","15",0,0.000974793003485288,0,"0"
"371830541061015","1","2","2","5","1","2","3","6","2","7","8",6,0.0863651057514875,69.4725022078337,"2"
"371830523023038","2","5","3","10","2","5","3","10","3","13","13",5,0.00563630221632223,887.106441084803,"2"
"371830545003008","1","2","3","6","1","2","3","6","3","9","9",63,0.00747111089398717,8432.48091133316,"27"
"371830518001018","4","4","5","13","4","4","5","13","3","16","16",74,0.0326400505929543,2267.15334859112,"42"
"371830518001011","4","4","5","13","4","4","5","13","4","17","17",59,0.0149771847129321,3939.3251222345,"32"
"371830504002011","4","4","5","13","5","5","5","15","4","17","19",0,0.000258581987335511,0,"0"
"371830505001020","5","4","5","14","5","5","5","15","4","18","19",40,0.0107437188996579,3723.10559998677,"25"
"371830505001031","5","4","5","14","5","5","5","15","4","18","19",20,0.00542306538061359,3687.95111183725,"5"
"371830527062021","2","1","2","5","2","1","4","7","3","8","10",20,0.0114273521982268,1750.18671456573,"10"
"371830527051026","3","3","4","10","3","3","4","10","2","12","12",0,0.00280504400858793,0,"0"
"371830542071112","2","4","1","7","2","5","1","8","3","10","11",0,0.000823211303167456,0,"0"
"371830542071092","2","4","1","7","2","5","1","8","3","10","11",9,0.00787105443576234,1143.43002877839,"3"
"371830538083029","4","5","2","11","4","5","3","12","5","16","17",7,0.00839421146854212,833.907988407605,"3"
"371830536101014","2","5","1","8","2","5","1","8","1","9","9",37,0.00153116133309191,24164.6645590802,"21"
"371830537181022","1","1","1","3","4","1","1","6","1","4","7",48,0.00839972971698815,5714.46958619653,"16"
"371830537122004","3","2","2","7","3","2","2","7","3","10","10",0,0.00261128156530156,0,"0"
"371830537241064","1","5","1","7","1","5","2","8","2","9","10",0,0.00342910328957754,0,"0"
"371830537121012","5","3","3","11","5","3","3","11","5","16","16",5,0.0044482891046951,1124.02766149407,"2"
"371830537252002","2","5","1","8","2","5","1","8","2","10","10",42,0.0330717910424145,1269.96448260498,"15"
"371830537252012","4","5","2","11","4","5","2","11","3","14","14",34,0.0187703117760992,1811.37108459185,"13"
"371830540162021","3","4","2","9","3","4","3","10","2","11","12",0,0.00337254690721617,0,"0"
"371830540131048","3","5","3","11","3","5","3","11","5","16","16",0,0.00206101678079006,0,"0"
"371830520023007","4","4","4","12","5","5","5","15","5","17","20",51,0.010878997879499,4687.93178975678,"17"
"371830540041004","4","3","4","11","4","3","4","11","2","13","13",34,0.00718455970549427,4732.37072189672,"20"
"371830540141006","1","2","1","4","2","3","2","7","3","7","10",10,0.000488860827530327,20455.7195767125,"5"
"371830541042026","4","5","3","12","4","5","3","12","5","17","17",124,0.0147864825681725,8386.03768193703,"46"
"371830515011029","3","3","4","10","3","3","5","11","4","14","15",21,0.00682219944541407,3078.18617265966,"9"
"371830515022002","5","4","4","13","5","4","5","14","4","17","18",29,0.0335448197197645,864.515005364995,"8"
"371830515012036","4","4","4","12","4","4","5","13","3","15","16",61,0.0133784564289415,4559.56935869216,"21"
"371830501001066","5","5","5","15","5","5","5","15","5","20","20",6,0.00851736862099673,704.442917406322,"4"
"371830501001049","5","5","5","15","5","5","5","15","5","20","20",37,0.00280732787668358,13179.7928939137,"18"
"371830509002017","5","5","5","15","5","5","5","15","5","20","20",41,0.00751548796169407,5455.40092792035,"13"
"371830526021002","4","2","4","10","4","3","4","11","3","13","14",80,0.0167425464303007,4778.24567087451,"31"
"371830528033001","1","2","2","5","5","3","4","12","3","8","15",135,0.01377598905843,9799.65935131088,"36"
"371830530081029","2","4","2","8","2","4","2","8","3","11","11",147,0.00622720466038246,23606.0974413151,"70"
"371830523023022","2","5","3","10","3","5","3","11","3","13","14",60,0.00150958488871211,39746.025843693,"16"
"371830540082001","3","3","3","9","3","3","3","9","2","11","11",33,0.00305354568862285,10807.1086419155,"15"
"371830524063002","1","5","2","8","3","5","2","10","2","10","12",23,0.0165998843079933,1385.55182513681,"11"
"371830526032006","3","3","4","10","3","3","5","11","3","13","14",0,0.00382710229609739,0,"0"
"371830517001016","5","4","5","14","5","5","5","15","4","18","19",17,0.0013298902744329,12783.0094909516,"4"
"371830518003003","4","4","5","13","4","4","5","13","5","18","18",0,0.00402688738097971,0,"0"
"371830526012001","3","4","4","11","3","4","4","11","3","14","14",25,0.00777531286239951,3215.30470122907,"9"
"371830511012001","5","4","5","14","5","5","5","15","5","19","20",0,0.00419016067181749,0,"0"
"371830540111004","2","4","3","9","2","4","3","9","3","12","12",0,0.00693322899996755,0,"0"
"371830527013011","4","3","4","11","4","4","5","13","4","15","17",28,0.024176871677936,1158.13163807925,"13"
"371830528062003","3","2","2","7","3","3","3","9","4","11","13",0,0.0242145869129309,0,"0"
"371830527052016","2","2","4","8","2","2","5","9","4","12","13",0,0.00102436953351364,0,"0"
"371830527051014","5","2","4","11","5","3","4","12","3","14","15",13,0.00466072318321419,2789.2667058237,"7"
"371830527061010","3","3","4","10","3","4","5","12","3","13","15",3,0.00557288580028014,538.320738574833,"1"
"371830527072017","2","3","4","9","2","3","4","9","3","12","12",0,0.048912174015233,0,"0"
"371830542081118","2","4","1","7","2","5","1","8","3","10","11",28,0.00262900971918621,10650.3980550773,"14"
"371830542071111","3","5","1","9","3","5","1","9","3","12","12",0,0.00146781072616751,0,"0"
"371830537132015","4","3","3","10","4","3","3","10","5","15","15",27,0.0111398598590495,2423.72887465603,"12"
"371830537241027","2","5","2","9","2","5","2","9","2","11","11",0,0.000460613897253996,0,"0"
"371830537232005","5","1","3","9","5","1","3","9","4","13","13",190,0.0469766638786468,4044.56136967965,"99"
"371830537091003","1","5","2","8","1","5","2","8","3","11","11",77,0.0044248709127248,17401.6375886961,"46"
"371830537222013","2","2","2","6","2","2","3","7","3","9","10",0,0.000714058598823516,0,"0"
"371830525052012","4","3","4","11","4","3","4","11","5","16","16",276,0.0093949906858646,29377.3574906531,"66"
"371830541042021","4","5","3","12","4","5","3","12","4","16","16",44,0.00359374002289611,12243.5122517687,"10"
"371830524071011","4","4","4","12","4","4","4","12","4","16","16",0,0.00926378360668688,0,"0"
"371830530081004","1","2","2","5","4","2","3","9","2","7","11",6,0.00779477007160051,769.746887321336,"2"
"371830524061006","3","4","3","10","3","4","3","10","3","13","13",76,0.01893116014797,4014.54530023346,"33"
"371830518003008","4","4","4","12","4","4","5","13","5","17","18",25,0.00592095661061601,4222.29069457731,"15"
"371830505003010","5","5","5","15","5","5","5","15","4","19","19",31,0.00834955869659807,3712.77107287486,"12"
"371830505001014","5","4","5","14","5","5","5","15","3","17","18",42,0.00742030100416965,5660.14774554283,"17"
"371830524082005","5","5","4","14","5","5","4","14","4","18","18",40,0.00381572737349071,10482.9292254722,"21"
"371830506002034","5","5","5","15","5","5","5","15","4","19","19",31,0.00485904850667927,6379.8498733625,"10"
"371830526022008","4","3","4","11","4","3","5","12","3","14","15",17,0.00571143092478433,2976.48701768059,"9"
"371830516004006","4","4","4","12","4","4","5","13","3","15","16",1,0.00373257140734537,267.911820262056,"1"
"371830510001009","5","5","5","15","5","5","5","15","4","19","19",2,0.0130060139271407,153.775016019815,"2"
"371830519001035","5","4","5","14","5","4","5","14","3","17","17",0,0.000712355018999553,0,"0"
"371830545002053","2","2","3","7","2","2","3","7","3","10","10",0,0.00818983978658955,0,"0"
"371830528061029","2","2","2","6","3","3","3","9","4","10","13",0,2.68637235011442e-05,0,"0"
"371830530082008","2","4","2","8","2","4","2","8","3","11","11",28,0.0159569753691015,1754.7185072566,"7"
"371830541061025","1","3","4","8","2","3","4","9","4","12","13",0,0.000895761542262596,0,"0"
"371830541052004","2","2","2","6","2","3","3","8","3","9","11",7,0.00354622128637601,1973.93209129188,"2"
"371830542071065","1","4","1","6","1","4","1","6","2","8","8",26,0.00729534429167773,3563.91678863736,"7"
"371830536101048","1","5","1","7","1","5","1","7","1","8","8",122,0.00544756830058384,22395.313517579,"57"
"371830540141001","1","2","1","4","5","5","2","12","5","9","17",0,0.0164601095423573,0,"0"
"371830527041005","3","2","4","9","3","2","4","9","2","11","11",0,0.0568632510170518,0,"0"
"371830537163007","5","4","4","13","5","4","4","13","5","18","18",53,0.0250554539665999,2115.30791142924,"23"
"371830537073006","4","4","3","11","4","4","4","12","5","16","17",20,0.00308901587257131,6474.55397610241,"12"
"371830540012005","5","3","4","12","5","3","4","12","3","15","15",63,0.0120296670807452,5237.05266131915,"22"
"371830540012012","3","2","4","9","3","3","4","10","2","11","12",87,0.0160424175173796,5423.1227871827,"32"
"371830540012015","3","3","4","10","3","3","4","10","2","12","12",11,0.0114387572760644,961.642924534949,"3"
"371830541062017","4","2","2","8","4","3","3","10","3","11","13",0,0.00114293121762685,0,"0"
"371830506001007","5","4","5","14","5","5","5","15","3","17","18",53,0.00535842770239519,9890.96110717501,"23"
"371830509001007","5","5","5","15","5","5","5","15","5","20","20",0,0.00717599894990037,0,"0"
"371830506001003","5","4","5","14","5","5","5","15","3","17","18",94,0.0117045849008968,8031.04089516218,"34"
"371830506002040","5","4","5","14","5","5","5","15","3","17","18",2,0.000611960850676106,3268.1829201825,"1"
"371830540143017","2","2","2","6","2","3","2","7","2","8","9",77,0.0125413178872088,6139.70562683323,"27"
"371830540162007","5","5","3","13","5","5","4","14","2","15","16",0,0.04887163692411,0,"0"
"371830541043010","1","2","2","5","2","2","2","6","3","8","9",253,0.0402546119342123,6284.99413715565,"77"
"371830524093003","5","5","4","14","5","5","5","15","4","18","19",118,0.00977991333918967,12065.5465858941,"38"
"371830526011010","4","4","4","12","4","4","4","12","4","16","16",57,0.0103186980126413,5523.9527244784,"16"
"371830511021016","5","5","5","15","5","5","5","15","5","20","20",317,0.007785079498698,40718.916236246,"0"
"371830510001008","4","5","5","14","5","5","5","15","5","19","20",5,0.00682321844785547,732.792015705065,"3"
"371830512003024","5","5","5","15","5","5","5","15","4","19","19",33,0.00476702844855594,6922.55151319614,"13"
"371830523021053","4","5","5","14","4","5","5","14","4","18","18",0,0.0205736251306996,0,"0"
"371830541062034","3","2","4","9","3","3","4","10","3","12","13",44,0.00893696211189775,4923.37322784696,"20"
"371830542081090","1","4","1","6","1","4","1","6","2","8","8",338,0.0130664824289102,25867.7116690685,"169"
"371830540181035","3","4","4","11","3","4","4","11","2","13","13",0,0.00547811108018514,0,"0"
"371830503001019","4","5","5","14","5","5","5","15","3","17","18",9,0.0014745954616751,6103.36884515854,"5"
"371830506002000","5","4","5","14","5","5","5","15","3","17","18",0,0.00467261441710775,0,"0"
"371830541061042","1","2","3","6","1","2","4","7","3","9","10",0,0.0098434222306169,0,"0"
"371830541041020","2","3","2","7","3","4","3","10","3","10","13",0,0.000218545386503305,0,"0"
"371830527052034","2","2","4","8","2","2","5","9","4","12","13",0,0.00493893887310688,0,"0"
"371830527051025","3","3","3","9","3","3","4","10","2","11","12",0,0.00274322041280348,0,"0"
"371830514003011","5","5","5","15","5","5","5","15","5","20","20",47,0.00943180330201667,4983.14039161002,"17"
"371830536101091","1","5","1","7","1","5","1","7","1","8","8",0,0.00133166217064234,0,"0"
"371830542071078","1","2","1","4","1","2","1","4","2","6","6",891,0.041100004518176,21678.8297336066,"308"
"371830537251006","2","5","2","9","2","5","2","9","3","12","12",0,0.000702477763638936,0,"0"
"371830537241082","2","5","2","9","2","5","2","9","3","12","12",23,0.00341543862594282,6734.12774139688,"15"
"371830537111006","5","5","2","12","5","5","2","12","2","14","14",16,0.00964573283237712,1658.76458305936,"4"
"371830540151046","4","4","3","11","4","4","3","11","2","13","13",0,0.00438986359518939,0,"0"
"371830537132003","5","3","3","11","5","3","3","11","5","16","16",22,0.00236120947799943,9317.25888998203,"16"
"371830537132011","3","2","3","8","3","2","3","8","4","12","12",0,0.00161583369286149,0,"0"
"371830537252046","2","5","2","9","2","5","2","9","3","12","12",0,0.000271701674040628,0,"0"
"371830537181017","1","5","1","7","3","5","2","10","2","9","12",0,0.00315043626633596,0,"0"
"371830537241039","3","5","2","10","3","5","2","10","2","12","12",22,0.00149322478040728,14733.2138393789,"13"
"371830540044000","3","4","4","11","3","4","4","11","2","13","13",270,0.0206051599670293,13103.5138980737,"115"
"371830540134002","1","4","1","6","1","4","1","6","4","10","10",0,0.000479293048521207,0,"0"
"371830514002000","5","5","5","15","5","5","5","15","4","19","19",83,0.0206845199208001,4012.66262489062,"36"
"371830514002013","5","5","5","15","5","5","5","15","4","19","19",26,0.00912091223719865,2850.59205963651,"13"
"371830537181000","1","1","1","3","3","1","1","5","1","4","6",843,0.453078184298578,1860.60602609916,"300"
"371830516002018","4","4","4","12","4","4","5","13","3","15","16",40,0.0123047498135493,3250.77718816795,"14"
"371830506003013","5","4","5","14","5","5","5","15","4","18","19",72,0.00419617316406544,17158.4911262917,"24"
"371830506002036","5","4","5","14","5","5","5","15","4","18","19",0,0.0051743674225122,0,"0"
"371830507002002","5","5","5","15","5","5","5","15","4","19","19",0,0.010504989884837,0,"0"
"371830507001020","5","5","5","15","5","5","5","15","5","20","20",67,0.0113443883026688,5906.00376260375,"29"
"371830507002004","5","5","5","15","5","5","5","15","5","20","20",44,0.00505378634551639,8706.34351985138,"21"
"371830528064020","4","1","1","6","4","2","2","8","3","9","11",35,0.0363718855786265,962.281703112125,"10"
"371830528064054","1","1","1","3","1","2","1","4","4","7","8",81,0.0086634124853391,9349.66448118158,"31"
"371830528033035","2","2","4","8","2","2","4","8","2","10","10",220,0.0229307050092649,9594.12281092584,"66"
"371830530031012","2","3","2","7","2","4","2","8","3","10","11",0,0.00599726931671553,0,"0"
"371830530082002","2","3","2","7","2","3","2","7","2","9","9",9,0.00791340123625145,1137.31121818654,"5"
"371830523022005","4","5","4","13","4","5","4","13","3","16","16",76,0.0195441341780099,3888.63478462564,"34"
"371830545004012","5","5","4","14","5","5","4","14","3","17","17",15,0.00590650658098231,2539.5722148684,"6"
"371830540112007","2","4","3","9","2","4","3","9","3","12","12",56,0.0169810233876739,3297.79888535158,"27"
"371830527072002","3","3","3","9","3","3","4","10","2","11","12",22,0.00383676150746651,5734.00248026546,"6"
"371830527072009","3","4","4","11","3","4","4","11","2","13","13",7,0.00280188710618835,2498.31621857267,"3"
"371830527071003","2","3","3","8","2","3","4","9","2","10","11",0,0.00271207016581279,0,"0"
"371830527061033","2","2","4","8","2","3","5","10","4","12","14",0,0.00344011465177332,0,"0"
"371830542071107","3","5","1","9","3","5","1","9","3","12","12",42,0.00291728023540732,14396.9713605988,"17"
"371830541063037","4","3","2","9","4","3","2","9","4","13","13",37,0.0056655141071848,6530.74007053975,"14"
"371830528062020","4","4","4","12","4","4","4","12","3","15","15",0,0.00659239328781164,0,"0"
"371830541062053","4","2","2","8","4","3","2","9","5","13","14",39,0.0174202772338341,2238.77034082174,"15"
"371830542091061","2","1","1","4","2","1","1","4","3","7","7",0,0.000936410200336061,0,"0"
"371830542071062","2","4","1","7","2","5","1","8","3","10","11",57,0.00601027648426486,9483.75672054826,"15"
"371830537171022","1","5","1","7","2","5","1","8","1","8","9",0,0.00039517120724277,0,"0"
"371830536101089","1","5","1","7","1","5","2","8","1","8","9",0,0.00478991873365189,0,"0"
"371830526023008","3","3","4","10","3","3","4","10","3","13","13",40,0.0151271282841282,2644.25601797594,"16"
"371830526021015","3","2","4","9","3","2","4","9","3","12","12",58,0.0134890553806494,4299.78218365114,"24"
"371830526021000","3","3","4","10","3","3","4","10","3","13","13",14,0.0043634453729791,3208.47376403423,"6"
"371830518001017","5","4","5","14","5","4","5","14","3","17","17",69,0.0112769556579688,6118.67263584047,"37"
"371830504001023","4","4","5","13","5","4","5","14","3","16","17",77,0.0142291522545428,5411.4256859833,"40"
"371830505001016","5","4","5","14","5","5","5","15","3","17","18",38,0.00566824948124197,6704.00978745802,"20"
"371830538084017","2","4","3","9","2","4","3","9","3","12","12",0,0.0027521161969983,0,"0"
"371830537092024","2","5","2","9","2","5","2","9","3","12","12",0,0.000625851720169975,0,"0"
"371830537093019","1","5","2","8","1","5","2","8","3","11","11",0,0.00873626824410251,0,"0"
"371830537092032","1","5","2","8","1","5","2","8","3","11","11",36,0.00630959582945624,5705.59525095643,"23"
"371830537142001","2","3","3","8","2","3","3","8","3","11","11",145,0.0368264937804976,3937.38271322448,"38"
"371830525033028","2","5","3","10","2","5","4","11","4","14","15",0,0.0377322699793334,0,"0"
"371830525033036","2","5","3","10","2","5","4","11","5","15","16",0,0.0101616519895606,0,"0"
"371830541061050","3","3","2","8","3","3","2","8","4","12","12",0,0.000926787991486156,0,"0"
"371830516003011","4","4","5","13","4","4","5","13","3","16","16",183,0.0409225937303634,4471.85731202123,"89"
"371830523021054","5","5","5","15","5","5","5","15","5","20","20",0,0.010740255265859,0,"0"
"371830509001012","4","5","5","14","4","5","5","14","4","18","18",0,0.00826418173169272,0,"0"
"371830516002004","3","4","4","11","3","4","5","12","3","14","15",0,0.00187353072033826,0,"0"
"371830545001002","5","5","5","15","5","5","5","15","5","20","20",38,0.0119471511572665,3180.67458089268,"14"
"371830507003043","4","4","5","13","4","4","5","13","5","18","18",153,0.0130541358270622,11720.4234755103,"57"
"371830545001004","5","5","5","15","5","5","5","15","5","20","20",112,0.00350321198062687,31970.6602453325,"48"
"371830541061046","3","3","2","8","3","3","2","8","3","11","11",99,0.0104918295490427,9435.91387348001,"36"
"371830527062010","3","2","4","9","3","2","4","9","3","12","12",0,0.00358730128878879,0,"0"
"371830527072014","5","5","3","13","5","5","4","14","2","15","16",61,0.0213409280945151,2858.35741209764,"24"
"371830541043004","1","3","3","7","5","4","3","12","3","10","15",0,0.000231445160270718,0,"0"
"371830541053003","1","2","2","5","1","2","2","5","5","10","10",30,0.0350036292702646,857.053986270071,"13"
"371830525062003","4","2","2","8","4","2","3","9","3","11","12",28,0.0193147857878484,1449.66660813892,"9"
"371830545001050","3","5","5","13","3","5","5","13","4","17","17",0,0.00566539982332768,0,"0"
"371830506002001","5","4","5","14","5","5","5","15","3","17","18",22,0.00764511683707675,2877.65386309153,"12"
"371830519001039","4","4","5","13","5","4","5","14","3","16","17",21,0.00641028496675328,3275.98540609595,"7"
"371830507003001","4","4","5","13","4","4","5","13","3","16","16",33,0.00333653356005242,9890.50444302486,"10"
"371830523021014","3","5","4","12","3","5","5","13","4","16","17",9,0.0255002119723021,352.938242622282,"5"
"371830528061023","4","3","4","11","4","4","4","12","5","16","17",0,0.0035366241893682,0,"0"
"371830541052007","2","3","2","7","2","3","3","8","3","10","11",59,0.0102121124377742,5777.45303525659,"20"
"371830541061029","1","2","2","5","1","2","3","6","3","8","9",43,0.0151201065877209,2843.89529601071,"12"
"371830540011010","4","3","4","11","4","3","4","11","3","14","14",70,0.0205696424524561,3403.07325038806,"32"
"371830541041017","1","3","2","6","3","4","3","10","4","10","14",0,0.00404757879847224,0,"0"
"371830540143021","3","2","1","6","3","3","2","8","3","9","11",0,0.000841302062765753,0,"0"
"371830541132015","4","1","1","6","4","2","1","7","4","10","11",0,0.0179255206546027,0,"0"
"371830542071071","1","4","1","6","1","5","1","7","2","8","9",0,0.0305402510830267,0,"0"
"371830515011006","5","3","4","12","5","3","5","13","4","16","17",0,0.00418531011362535,0,"0"
"371830540151028","2","3","2","7","2","4","3","9","3","10","12",0,0.00523072640339685,0,"0"
"371830541041001","4","4","1","9","4","4","1","9","4","13","13",2,0.00233559599671579,856.312479903336,"1"
"371830506003027","5","5","5","15","5","5","5","15","5","20","20",4,0.00242198608003569,1651.53715497038,"2"
"371830507002008","5","5","5","15","5","5","5","15","5","20","20",56,0.00320350329212818,17480.8623226972,"16"
"371830506002019","5","4","5","14","5","5","5","15","4","18","19",37,0.00385445728030653,9599.27619098103,"14"
"371830507003004","5","4","5","14","5","5","5","15","4","18","19",4,0.00136476623936659,2930.90485727173,"1"
"371830508001002","5","5","5","15","5","5","5","15","4","19","19",87,0.010782049309449,8068.96699347836,"36"
"371830528033059","1","1","2","4","1","1","2","4","3","7","7",0,0.00639831263078531,0,"0"
"371830521021009","2","3","4","9","2","3","4","9","3","12","12",0,0.0102771618149984,0,"0"
"371830520012025","3","4","5","12","4","5","5","14","4","16","18",40,0.00770872474112136,5188.92570993284,"18"
"371830504001020","5","4","5","14","5","4","5","14","3","17","17",370,0.14071476536366,2629.43266148211,"176"
"371830520024003","3","4","5","12","5","4","5","14","4","16","18",32,0.0065416293256106,4891.74766823296,"15"
"371830520021009","4","4","4","12","4","5","5","14","4","16","18",46,0.0142840958856556,3220.36482870394,"20"
"371830520023001","3","4","4","11","5","5","5","15","5","16","20",37,0.0101081926353981,3660.39719805386,"18"
"371830520021018","5","4","4","13","5","5","5","15","5","18","20",41,0.0100852004246766,4065.36293514611,"17"
"371830541062018","3","3","3","9","3","4","4","11","3","12","14",0,0.0235250330213235,0,"0"
"371830527012037","2","2","4","8","2","3","4","9","3","11","12",46,0.0144411300305352,3185.34629234242,"24"
"371830527052011","5","3","4","12","5","3","5","13","3","15","16",125,0.018088761519995,6910.36806814149,"41"
"371830527061017","3","3","4","10","3","4","4","11","3","13","14",0,0.00272440625355903,0,"0"
"371830542071072","2","4","1","7","2","4","1","7","2","9","9",51,0.00986530503955082,5169.63234238949,"15"
"371830527051021","3","3","3","9","3","3","4","10","2","11","12",80,0.00536993742918949,14897.7527308125,"37"
"371830526023005","3","3","4","10","3","3","5","11","3","13","14",8,0.0214286314796009,373.332287113884,"3"
"371830525052001","4","4","3","11","4","4","4","12","4","15","16",6,0.00678895940415912,883.787874224762,"4"
"371830537071030","3","3","3","9","3","3","3","9","3","12","12",31,0.0122949677304589,2521.35675990448,"13"
"371830540062000","2","2","3","7","2","2","3","7","3","10","10",119,0.0346195348586775,3437.3656516697,"47"
"371830521013009","3","3","4","10","3","3","5","11","3","13","14",37,0.010590522759608,3493.68967329139,"13"
"371830527052017","3","3","4","10","3","3","5","11","4","14","15",0,0.00692866729290954,0,"0"
"371830541043018","3","4","3","10","4","4","4","12","2","12","14",0,0.00209015059155593,0,"0"
"371830507003041","5","4","5","14","5","5","5","15","5","19","20",48,0.0341919146328315,1403.8406598591,"41"
"371830526011013","3","3","4","10","5","3","4","12","4","14","16",58,0.0241590367571218,2400.75796825394,"30"
"371830526011021","4","3","4","11","4","4","4","12","4","15","16",51,0.0157097599848609,3246.38950876064,"24"
"371830503002016","4","5","5","14","4","5","5","14","4","18","18",133,0.0113758042772103,11691.4810380875,"112"
"371830510001001","4","5","5","14","5","5","5","15","4","18","19",0,0.00477677399874357,0,"0"
"371830501001009","4","5","5","14","5","5","5","15","3","17","18",0,0.00052194532240492,0,"0"
"371830501001059","5","5","5","15","5","5","5","15","4","19","19",0,0.00286267762201676,0,"0"
"371830510002022","5","5","5","15","5","5","5","15","5","20","20",16,0.0021622669839874,7399.64126469463,"9"
"371830542102040","2","1","1","4","2","2","1","5","3","7","8",0,0.00427041251460596,0,"0"
"371830508003002","5","5","5","15","5","5","5","15","4","19","19",10,0.00383418735954027,2608.11459177076,"3"
"371830545001032","5","5","5","15","5","5","5","15","5","20","20",40,0.00945220337930564,4231.81753447823,"14"
"371830510002009","5","5","5","15","5","5","5","15","5","20","20",23,0.0020130776029047,11425.2922822314,"13"
"371830541063029","3","3","2","8","3","3","2","8","3","11","11",0,0.00295540160906532,0,"0"
"371830541061045","3","2","2","7","3","2","2","7","3","10","10",3,0.000972484361622123,3084.8825116282,"2"
"371830541051007","5","3","2","10","5","3","2","10","5","15","15",7,0.00184438846720109,3795.29590673634,"3"
"371830524011011","1","5","1","7","1","5","1","7","3","10","10",0,0.0270569016328795,0,"0"
"371830537222006","4","2","3","9","4","2","3","9","4","13","13",38,0.0109303055696004,3476.57252196923,"15"
"371830540013001","3","3","3","9","3","3","3","9","3","12","12",459,0.0157544235303129,29134.6744053722,"199"
"371830540012002","2","2","3","7","2","2","4","8","2","9","10",89,0.040556505090768,2194.46916840621,"39"
"371830537093016","3","5","2","10","3","5","2","10","2","12","12",244,0.009252747041621,26370.5469200046,"111"
"371830525043026","3","5","3","11","3","5","3","11","3","14","14",31,0.00136432327249469,22721.8875650461,"23"
"371830527062005","3","2","4","9","3","2","4","9","3","12","12",10,0.000278047273483738,35965.107208954,"9"
"371830540171005","1","2","2","5","1","3","2","6","2","7","8",0,0.00829310543462781,0,"0"
"371830540141011","1","2","1","4","1","3","2","6","3","7","9",94,0.0037945912995027,24772.1012832974,"27"
"371830515022019","5","3","4","12","5","3","5","13","4","16","17",91,0.0183924187859243,4947.69073383879,"36"
"371830514003003","5","5","5","15","5","5","5","15","5","20","20",70,0.0138777744633681,5044.03643284249,"36"
"371830516004015","5","4","5","14","5","4","5","14","3","17","17",65,0.0152342354756357,4266.70574338667,"26"
"371830514001017","5","5","5","15","5","5","5","15","3","18","18",31,0.00727600336624634,4260.58076660742,"16"
"371830517003012","3","3","4","10","4","3","5","12","5","15","17",54,0.0162613684345441,3320.75373713859,"21"
"371830517003022","4","3","4","11","4","3","5","12","5","16","17",40,0.0191812431292147,2085.37057429175,"17"
"371830525033016","3","5","3","11","3","5","3","11","4","15","15",33,0.00352622802072281,9358.44188352732,"20"
"371830535211073","1","5","2","8","1","5","2","8","2","10","10",0,0.00641124283076685,0,"0"
"371830530031006","1","4","2","7","3","4","2","9","3","10","12",0,0.000369502348661333,0,"0"
"371830525061011","2","3","3","8","2","3","4","9","4","12","13",0,0.00120699001590522,0,"0"
"371830537222015","2","2","3","7","2","2","3","7","3","10","10",16,0.000992510352845476,16120.7386443162,"13"
"371830537092025","2","5","2","9","2","5","2","9","3","12","12",0,0.00131848576644963,0,"0"
"371830537222010","2","2","2","6","2","2","2","6","3","9","9",0,0.000508105044375263,0,"0"
"371830537262020","2","5","2","9","2","5","2","9","3","12","12",0,0.00570207495654924,0,"0"
"371830537141013","4","2","3","9","4","2","3","9","4","13","13",60,0.0115718262100266,5185.00700848862,"22"
"371830525032011","3","5","3","11","3","5","3","11","5","16","16",80,0.00271015184091061,29518.6412777227,"45"
"371830525043042","4","5","3","12","4","5","4","13","3","15","16",13,0.00108647913538789,11965.2550855096,"8"
"371830537221006","2","2","2","6","2","2","2","6","3","9","9",57,0.0058090005622371,9812.35918112028,"36"
"371830525061015","3","3","3","9","3","3","4","10","5","14","15",0,0.00123177364266982,0,"0"
"371830537221001","2","2","2","6","2","2","2","6","3","9","9",50,0.0118515665088487,4218.85157229371,"19"
"371830525072005","3","5","2","10","3","5","2","10","4","14","14",0,0.00136391145028758,0,"0"
"371830537071018","3","3","3","9","3","3","3","9","3","12","12",138,0.0657800471622307,2097.90059377209,"55"
"371830540132031","1","4","1","6","1","5","2","8","5","11","13",41,0.00592324368344978,6921.88304096938,"12"
"371830540151043","4","3","3","10","4","4","3","11","2","12","13",0,0.0041277096254989,0,"0"
"371830540132023","2","4","1","7","2","5","2","9","4","11","13",0,0.00035757305341482,0,"0"
"371830540132041","1","4","1","6","1","5","2","8","5","11","13",98,0.00852526384098632,11495.2454056439,"22"
"371830540132035","1","4","1","6","1","5","2","8","5","11","13",0,0.00171729424088728,0,"0"
"371830506003005","5","5","5","15","5","5","5","15","4","19","19",30,0.00458855425250055,6538.00703863344,"16"
"371830501001097","5","5","5","15","5","5","5","15","5","20","20",231,0.00859052802757504,26890.0816409079,"1"
"371830509002004","5","5","5","15","5","5","5","15","5","20","20",20,0.00454325919395002,4402.12612712759,"11"
"371830528061000","2","1","2","5","2","2","2","6","5","10","11",30,0.119839451982648,250.334923129855,"11"
"371830509003011","5","5","5","15","5","5","5","15","5","20","20",49,0.00749382102037954,6538.7203493043,"18"
"371830508001012","5","5","5","15","5","5","5","15","5","20","20",43,0.0044152895484984,9738.88564445879,"14"
"371830509002020","5","5","5","15","5","5","5","15","5","20","20",46,0.00426909856180543,10775.108453,"11"
"371830521021018","1","1","3","5","1","2","4","7","3","8","10",0,0.00825089418854192,0,"0"
"371830541044017","3","4","3","10","3","4","3","10","3","13","13",1,0.00285678130918485,350.044295230054,"1"
"371830541131016","1","1","1","3","4","3","2","9","5","8","14",16,0.00668766041498705,2392.46597571611,"8"
"371830541043041","3","4","3","10","3","4","3","10","3","13","13",98,0.00468194393618847,20931.4766122084,"28"
"371830541063021","3","3","2","8","3","3","2","8","4","12","12",0,0.00885992383866054,0,"0"
"371830541043046","2","3","3","8","5","4","4","13","2","10","15",0,0.00026047483433717,0,"0"
"371830542091067","3","1","1","5","3","1","1","5","3","8","8",65,0.00583667577017843,11136.4760626429,"18"
"371830542071081","1","2","1","4","1","2","1","4","2","6","6",0,0.00341768979275,0,"0"
"371830525072000","2","5","2","9","2","5","2","9","3","12","12",0,0.00178091351179153,0,"0"
"371830541101007","3","2","1","6","3","3","1","7","4","10","11",83,0.0142355608431066,5830.46926740452,"33"
"371830541103019","1","1","1","3","2","2","1","5","2","5","7",30,0.00554288435565135,5412.34456198116,"16"
"371830521012010","5","4","5","14","5","4","5","14","3","17","17",25,0.00563122553902115,4439.53093811718,"11"
"371830521011020","5","4","4","13","5","4","5","14","3","16","17",42,0.00416280167923682,10089.3588588395,"14"
"371830528062009","3","3","3","9","3","4","4","11","3","12","14",0,0.00951608199013386,0,"0"
"371830527063003","3","3","3","9","3","4","4","11","3","12","14",81,0.010261600064974,7893.50583604185,"25"
"371830527073022","3","4","3","10","3","4","4","11","2","12","13",3,0.00606441282926998,494.689277339507,"2"
"371830527061012","3","2","3","8","3","2","4","9","3","11","12",79,0.0101773937172105,7762.30164569609,"22"
"371830540011003","5","4","4","13","5","4","4","13","4","17","17",42,0.00543587063139644,7726.4531936093,"24"
"371830537091016","1","5","2","8","1","5","2","8","2","10","10",0,0.0138656309864557,0,"0"
"371830525072008","3","5","2","10","3","5","2","10","3","13","13",0,0.00158262685483436,0,"0"
"371830541041038","2","2","2","6","3","3","3","9","2","8","11",57,0.00708269169544763,8047.78782572684,"18"
"371830541041037","2","2","2","6","2","3","3","8","2","8","10",56,0.00656897421942538,8524.92308987911,"19"
"371830540134030","3","4","2","9","3","5","3","11","3","12","14",1,0.0063024233937976,158.669124163275,"1"
"371830541043049","3","3","3","9","5","4","4","13","2","11","15",4,0.00493112886435349,811.173285069772,"2"
"371830515011017","4","3","4","11","4","3","5","12","5","16","17",0,0.00457784482208984,0,"0"
"371830515021005","2","1","3","6","2","1","3","6","4","10","10",0,0.0127773684960239,0,"0"
"371830514004003","5","5","5","15","5","5","5","15","5","20","20",40,0.00777941354266079,5141.7757624849,"22"
"371830528072035","1","1","2","4","1","2","2","5","3","7","8",0,0.0197628503012897,0,"0"
"371830541044009","2","2","3","7","5","3","4","12","2","9","14",22,0.00430883672221607,5105.78641482734,"7"
"371830528062039","1","1","2","4","5","3","3","11","5","9","16",77,0.00446875408207486,17230.7534909705,"20"
"371830537162009","4","4","4","12","4","4","4","12","4","16","16",30,0.01514419540867,1980.95700632766,"11"
"371830537093025","1","5","2","8","1","5","2","8","3","11","11",0,0.00918359143528214,0,"0"
"371830540072015","2","2","3","7","3","2","3","8","4","11","12",552,0.0439036941470066,12572.9738857894,"308"
"371830521021012","3","3","4","10","3","3","4","10","5","15","15",47,0.00344831789480909,13629.8338592133,"9"
"371830516004002","4","4","4","12","4","4","5","13","3","15","16",109,0.0488878741484785,2229.59173207151,"42"
"371830527062017","1","2","3","6","1","2","4","7","3","9","10",0,0.00792077432129798,0,"0"
"371830527013021","5","4","5","14","5","4","5","14","5","19","19",0,0.000884574484838966,0,"0"
"371830521011017","3","3","4","10","3","3","5","11","3","13","14",3,0.00173348582986364,1730.61697322094,"1"
"371830528033068","1","1","2","4","1","1","2","4","3","7","7",0,0.0360894429099811,0,"0"
"371830528064035","1","1","1","3","1","2","1","4","5","8","9",60,0.00931881210988017,6438.58887726534,"24"
"371830541063007","3","3","2","8","3","3","2","8","3","11","11",212,0.00512427424323714,41371.7123512254,"94"
"371830541051038","4","3","2","9","4","3","2","9","4","13","13",0,0.00195078404429371,0,"0"
"371830521022005","4","2","4","10","4","2","4","10","3","13","13",72,0.00523929717863144,13742.3012181201,"23"
"371830525043045","4","5","4","13","4","5","4","13","4","17","17",2,0.00482320818755669,414.661760850333,"1"
"371830525043034","5","5","4","14","5","5","5","15","5","19","20",2,0.000835669893001206,2393.2895234711,"1"
"371830525031017","2","5","2","9","2","5","2","9","3","12","12",13,0.00143067487076316,9086.62077294014,"10"
"371830511022001","4","5","5","14","4","5","5","14","5","19","19",2022,0.042905127067317,47127.2348600096,"0"
"371830503001034","5","5","5","15","5","5","5","15","3","18","18",0,0.000242100624658018,0,"0"
"371830526032002","3","3","4","10","3","3","5","11","4","14","15",142,0.0226702723693467,6263.7094820265,"109"
"371830507001011","5","5","5","15","5","5","5","15","5","20","20",35,0.00542001629557488,6457.54516062534,"23"
"371830520012008","3","4","4","11","4","5","5","14","4","15","18",4,0.00487857723880212,819.911175780043,"2"
"371830527052038","3","3","4","10","3","3","5","11","5","15","16",0,0.025088910900367,0,"0"
"371830512003028","5","5","5","15","5","5","5","15","4","19","19",22,0.00648812067705454,3390.81239314857,"13"
"371830541052029","1","3","2","6","1","3","3","7","3","9","10",129,0.0113461708222219,11369.4745144634,"48"
"371830514005007","5","5","5","15","5","5","5","15","3","18","18",0,0.00286357889049404,0,"0"
"371830541062048","5","2","2","9","5","3","3","11","5","14","16",0,0.000870727489491949,0,"0"
"371830541063012","3","3","2","8","3","3","2","8","4","12","12",0,0.00922600735978066,0,"0"
"371830526022002","5","3","4","12","5","3","4","12","2","14","14",85,0.0143067145434131,5941.26623146575,"25"
"371830528062036","1","1","2","4","3","3","3","9","5","9","14",0,0.00197298282213169,0,"0"
"371830527062006","4","2","4","10","4","2","5","11","4","14","15",0,0.030461151611998,0,"0"
"371830541052011","1","2","2","5","1","2","2","5","3","8","8",121,0.0230268154913999,5254.74310788616,"43"
"371830541102012","1","1","1","3","1","1","1","3","3","6","6",129,0.0166703036887352,7738.31133545399,"41"
"371830501001023","4","5","5","14","4","5","5","14","4","18","18",0,0.00503705067092651,0,"0"
"371830515012026","3","2","4","9","3","2","4","9","4","13","13",0,0.00720420846695445,0,"0"
"371830518001009","3","4","5","12","5","4","5","14","4","16","18",79,0.0202208652814124,3906.85556233932,"49"
"371830528072034","1","1","1","3","1","1","2","4","3","6","7",0,0.00316194927790476,0,"0"
"371830541043021","3","4","3","10","3","4","3","10","3","13","13",73,0.00492742840487113,14815.0300728538,"21"
"371830527051028","2","3","4","9","2","3","4","9","3","12","12",5,0.00180204229831606,2774.62965473802,"2"
"371830528062002","4","2","2","8","4","3","3","10","3","11","13",79,0.00306841620267398,25746.1813463099,"30"
"371830542071052","1","2","1","4","1","2","1","4","2","6","6",0,0.00481411993871763,0,"0"
"371830537143002","2","2","2","6","2","2","2","6","3","9","9",226,0.0532921849861893,4240.77188913474,"103"
"371830541102033","1","1","1","3","1","1","1","3","2","5","5",12,0.00463373581601553,2589.70309842105,"4"
"371830540043009","3","4","4","11","3","4","4","11","2","13","13",0,0.00232959408168272,0,"0"
"371830540131002","3","5","2","10","3","5","2","10","4","14","14",0,0.000894844278266321,0,"0"
"371830540171046","1","2","2","5","1","2","2","5","2","7","7",0,0.00207626390648795,0,"0"
"371830536102015","4","5","1","10","4","5","2","11","1","11","12",148,0.00547437449102358,27035.0521767698,"78"
"371830528072014","4","3","2","9","4","4","3","11","3","12","14",0,0.00307808111108744,0,"0"
"371830536101023","1","5","1","7","1","5","1","7","1","8","8",0,0.00240057510893632,0,"0"
"371830518003018","4","4","5","13","4","4","5","13","4","17","17",256,0.0460882244845477,5554.56416173791,"137"
"371830541061031","2","3","3","8","2","3","4","9","3","11","12",0,0.00198124479344102,0,"0"
"371830524072007","2","4","3","9","3","4","4","11","3","12","14",242,0.014290311044705,16934.5509165574,"93"
"371830514004014","4","5","5","14","4","5","5","14","4","18","18",0,0.00556479609384409,0,"0"
"371830506002024","5","4","5","14","5","4","5","14","3","17","17",0,0.0037760284690292,0,"0"
"371830508002007","5","5","5","15","5","5","5","15","5","20","20",69,0.00300494585266411,22962.1442059684,"16"
"371830519001034","5","4","5","14","5","5","5","15","3","17","18",0,0.000109694916106869,0,"0"
"371830541062046","5","2","2","9","5","2","3","10","4","13","14",43,0.00991460250893383,4337.03720963636,"12"
"371830541062040","4","3","2","9","4","4","3","11","5","14","16",0,0.000159907866277777,0,"0"
"371830527051000","2","2","3","7","2","3","3","8","2","9","10",0,0.00267603359674765,0,"0"
"371830541054003","3","4","3","10","3","4","3","10","3","13","13",34,0.0420989912735394,807.620300901844,"12"
"371830540131015","1","5","2","8","1","5","2","8","4","12","12",2,0.000360550556986713,5547.07227944652,"1"
"371830540143024","2","4","3","9","2","4","3","9","2","11","11",0,0.00253951657142753,0,"0"
"371830540171059","1","3","2","6","1","4","2","7","2","8","9",0,0.00981843117059663,0,"0"
"371830540161011","3","5","2","10","3","5","3","11","4","14","15",39,0.00436286909077648,8939.07178706088,"14"
"371830510002011","5","5","5","15","5","5","5","15","5","20","20",37,0.00818468059096146,4520.64067605277,"17"
"371830501001086","5","5","5","15","5","5","5","15","5","20","20",10,0.00484093551742406,2065.71642278788,"4"
"371830510002020","5","5","5","15","5","5","5","15","5","20","20",33,0.00480154356859367,6872.78987029278,"16"
"371830510002010","5","5","5","15","5","5","5","15","5","20","20",21,0.00814763047834404,2577.43647749083,"13"
"371830507003038","5","5","5","15","5","5","5","15","4","19","19",24,0.00308244859611105,7786.01791779413,"11"
"371830506002022","5","4","5","14","5","4","5","14","3","17","17",16,0.00464678256031712,3443.24267217446,"10"
"371830519001036","5","4","5","14","5","5","5","15","3","17","18",24,0.0109725463034157,2187.27716760958,"9"
"371830507003005","4","4","5","13","4","5","5","14","3","16","17",42,0.00234561108595727,17905.7816751661,"14"
"371830519001042","4","4","5","13","5","4","5","14","3","16","17",49,0.0321550660441453,1523.86563077583,"23"
"371830526021004","4","3","4","11","4","3","4","11","3","14","14",63,0.0127128324072923,4955.62263244044,"21"
"371830541061027","1","1","1","3","1","1","2","4","2","5","6",21,0.0945892353135806,222.012578179548,"7"
"371830527073014","3","3","3","9","3","3","4","10","2","11","12",141,0.00376757594803646,37424.5939417584,"66"
"371830523013029","2","5","3","10","2","5","3","10","3","13","13",54,0.00289797135453763,18633.7245588874,"24"
"371830523022001","4","5","4","13","4","5","4","13","4","17","17",758,0.169848990128601,4462.78779418166,"294"
"371830527013015","1","2","3","6","1","2","4","7","3","9","10",0,0.00244006289967126,0,"0"
"371830527013018","4","4","5","13","4","4","5","13","5","18","18",0,0.00314093912152982,0,"0"
"371830518001021","5","4","5","14","5","4","5","14","4","18","18",31,0.00559325590811172,5542.38899654881,"17"
"371830518001031","5","4","5","14","5","4","5","14","3","17","17",46,0.00621073368627219,7406.53235569824,"19"
"371830504001035","5","4","5","14","5","4","5","14","3","17","17",41,0.00724942136902473,5655.62379573968,"18"
"371830504002015","5","4","5","14","5","4","5","14","4","18","18",38,0.00796212864970754,4772.59306798513,"26"
"371830541062028","3","2","4","9","3","3","4","10","3","12","13",33,0.00406731538189231,8113.45983813206,"19"
"371830540162019","5","5","3","13","5","5","4","14","5","18","19",214,0.0357012773391299,5994.18328837911,"61"
"371830526011009","3","4","3","10","3","4","4","11","4","14","15",41,0.00952660661797465,4303.73601473602,"16"
"371830512003017","5","5","5","15","5","5","5","15","4","19","19",0,0.00389836761742313,0,"0"
"371830523021006","5","5","5","15","5","5","5","15","5","20","20",34,0.0060591742717848,5611.32564850044,"18"
"371830545001013","4","5","5","14","4","5","5","14","4","18","18",0,0.0051212913648913,0,"0"
"371830526031003","4","2","4","10","4","3","4","11","5","15","16",56,0.0308313077939623,1816.33553705323,"19"
"371830501001013","3","5","5","13","5","5","5","15","3","16","18",0,0.00471309694272862,0,"0"
"371830501001027","4","5","5","14","4","5","5","14","4","18","18",0,0.00834429578006414,0,"0"
"371830528072019","5","3","2","10","5","4","3","12","3","13","15",13,0.0117048940246659,1110.64653576571,"8"
"371830530091001","2","5","2","9","2","5","2","9","2","11","11",9,0.0707498741513343,127.20870684164,"5"
"371830536102006","1","5","1","7","1","5","1","7","1","8","8",0,0.00764387224628162,0,"0"
"371830536101018","2","5","1","8","2","5","1","8","1","9","9",48,0.0106095698213878,4524.21736301096,"15"
"371830536102036","5","1","2","8","5","1","2","8","1","9","9",0,0.0471525704734311,0,"0"
"371830537111021","2","5","2","9","2","5","2","9","3","12","12",50,0.0367380183354071,1360.98794288562,"23"
"371830524082002","5","5","4","14","5","5","5","15","4","18","19",66,0.00547415037015089,12056.6655165121,"37"
"371830524071008","3","5","4","12","3","5","4","12","3","15","15",0,0.0180194506653803,0,"0"
"371830527052029","2","2","4","8","2","3","5","10","4","12","14",80,0.000653452303956793,122426.685950272,"29"
"371830515022023","5","5","5","15","5","5","5","15","4","19","19",41,0.00895945808828225,4576.1696294581,"23"
"371830504002003","5","4","5","14","5","4","5","14","3","17","17",87,0.00501333154741794,17353.7295862286,"42"
"371830527073038","3","3","3","9","3","4","4","11","3","12","14",35,0.0126945618295207,2757.08610269706,"14"
"371830541061016","1","2","2","5","1","2","3","6","2","7","8",18,0.0236057384775499,762.52645165576,"3"
"371830540151035","4","3","3","10","4","3","3","10","3","13","13",0,0.00946457167499309,0,"0"
"371830540132020","2","5","1","8","2","5","2","9","4","12","13",53,0.00658687645546014,8046.30242549427,"20"
"371830540132024","2","4","1","7","2","5","2","9","4","11","13",0,0.000339422317544035,0,"0"
"371830540132026","2","4","1","7","2","5","2","9","4","11","13",45,0.00430310069414875,10457.5754086326,"16"
"371830540132044","1","4","1","6","1","5","2","8","5","11","13",53,0.0055079739773358,9622.41292680109,"15"
"371830540134041","1","4","1","6","1","4","1","6","5","11","11",19,0.00228555479329095,8313.08006956248,"5"
"371830540143009","1","2","1","4","1","3","2","6","2","6","8",0,0.00260381539412044,0,"0"
"371830516003004","4","4","5","13","5","4","5","14","3","16","17",12,0.00355192348628373,3378.45115367483,"5"
"371830516001017","3","4","5","12","4","4","5","13","3","15","16",3,0.000983985975987952,3048.82393978015,"1"
"371830514005015","5","5","5","15","5","5","5","15","3","18","18",31,0.00498736995560907,6215.7009156972,"13"
"371830523023019","1","5","3","9","2","5","3","10","3","12","13",82,0.00265670910820275,30865.253462195,"20"
"371830545003007","1","2","3","6","1","2","3","6","3","9","9",49,0.00839918184155835,5833.90155426242,"28"
"371830538084014","3","4","3","10","3","4","3","10","3","13","13",0,0.000276006295847642,0,"0"
"371830537121019","5","3","3","11","5","3","3","11","5","16","16",39,0.0105097888234158,3710.82622641361,"14"
"371830537252018","5","5","3","13","5","5","3","13","4","17","17",10,0.00189752479071938,5270.02337408663,"2"
"371830537181021","1","1","1","3","3","1","1","5","1","4","6",68,0.0118821121272761,5722.8882602363,"25"
"371830537241045","3","5","2","10","3","5","2","10","2","12","12",32,0.00244360948037649,13095.3821619115,"16"
"371830537111000","4","2","2","8","4","2","2","8","3","11","11",0,0.000714611129499773,0,"0"
"371830540181020","3","4","4","11","3","4","4","11","2","13","13",277,0.0183028966438843,15134.2164789285,"128"
"371830504002009","5","4","5","14","5","4","5","14","3","17","17",0,0.000716513411007362,0,"0"
"371830540161006","4","5","3","12","4","5","3","12","4","16","16",100,0.0211081002168412,4737.51777624281,"39"
"371830540181003","2","3","3","8","2","3","3","8","2","10","10",0,0.0319937862650363,0,"0"
"371830540141088","1","3","2","6","2","4","3","9","3","9","12",109,0.0140404009124053,7763.31108207129,"38"
"371830524062004","1","5","3","9","2","5","3","10","3","12","13",2,0.0014855980059575,1346.25921142844,"1"
"371830520011006","1","2","3","6","3","3","4","10","4","10","14",0,0.00132404251853232,0,"0"
"371830524072014","4","5","4","13","4","5","4","13","4","17","17",0,0.00223473348380151,0,"0"
"371830507003029","5","5","5","15","5","5","5","15","4","19","19",17,0.00700083656939353,2428.28122489262,"4"
"371830545001044","4","5","5","14","4","5","5","14","5","19","19",0,0.00540735715180541,0,"0"
"371830512002017","4","5","5","14","5","5","5","15","4","18","19",92,0.0285549693813881,3221.85601991802,"28"
"371830540133008","1","4","1","6","1","5","2","8","5","11","13",4,0.0427425882461857,93.5834764371565,"2"
"371830540141030","2","2","1","5","2","3","2","7","5","10","12",153,0.013195912571073,11594.4993706153,"45"
"371830540171000","3","4","3","10","3","5","3","11","2","12","13",0,0.00442336880785762,0,"0"
"371830524011058","2","5","3","10","2","5","4","11","4","14","15",0,0.00628002251957825,0,"0"
"371830541041009","2","3","1","6","2","4","2","8","5","11","13",0,0.00670949528376158,0,"0"
"371830541043019","3","3","3","9","4","3","3","10","2","11","12",0,0.00187229948990384,0,"0"
"371830506002016","5","4","5","14","5","5","5","15","4","18","19",35,0.00379980350750934,9211.00260337974,"15"
"371830507003020","5","4","5","14","5","5","5","15","4","18","19",46,0.00663849339475501,6929.28308648225,"18"
"371830507003014","5","4","5","14","5","5","5","15","3","17","18",3,0.00234871801461604,1277.29254058216,"1"
"371830507003008","5","4","5","14","5","4","5","14","4","18","18",16,0.00691981807820748,2312.19951437577,"8"
"371830508003003","5","5","5","15","5","5","5","15","4","19","19",128,0.0204464541489045,6260.25417746374,"33"
"371830524071022","3","5","4","12","3","5","4","12","4","16","16",0,0.00213799962216106,0,"0"
"371830517002006","4","4","4","12","5","5","5","15","5","17","20",113,0.0417755259580275,2704.93302977281,"38"
"371830514005013","5","5","5","15","5","5","5","15","3","18","18",12,0.00373877857540683,3209.60435553321,"5"
"371830512002009","5","5","5","15","5","5","5","15","4","19","19",27,0.0125351745185395,2153.93889890141,"11"
"371830516001016","4","4","5","13","5","4","5","14","3","16","17",0,0.000203829112627333,0,"0"
"371830507003032","5","5","5","15","5","5","5","15","4","19","19",1,0.0075821321448002,131.889022889926,"1"
"371830503001001","4","4","5","13","5","5","5","15","3","16","18",0,0.000585593728791024,0,"0"
"371830503001033","5","5","5","15","5","5","5","15","3","18","18",25,0.00428051175131843,5840.4231672299,"13"
"371830518001030","4","4","5","13","4","4","5","13","3","16","16",48,0.00781416331622119,6142.69219333543,"23"
"371830524082010","4","5","4","13","4","5","4","13","4","17","17",107,0.00768077564164168,13930.8847168891,"39"
"371830521011014","3","3","4","10","3","3","4","10","3","13","13",0,0.0012768575749517,0,"0"
"371830528064021","4","1","1","6","4","3","2","9","3","9","12",67,0.00638168925143307,10498.7876031342,"19"
"371830528072009","4","2","2","8","4","3","2","9","3","11","12",25,0.00332056462750299,7528.84006320323,"7"
"371830537211027","1","1","1","3","1","1","1","3","2","5","5",0,0.0106036083252781,0,"0"
"371830537111008","4","5","2","11","4","5","2","11","2","13","13",24,0.0067483877229056,3556.40502375677,"9"
"371830537251027","3","5","3","11","3","5","3","11","4","15","15",55,0.00364021905842189,15108.9808380498,"28"
"371830537181020","1","1","1","3","1","1","1","3","1","4","4",0,0.0109884079887035,0,"0"
"371830524011072","3","5","4","12","3","5","4","12","3","15","15",8,0.00588754547320006,1358.80054539125,"4"
"371839802001009","1","5","1","7","1","5","1","7","2","9","9",0,0.0260663415992635,0,"0"
"371839802001008","1","5","1","7","1","5","1","7","1","8","8",0,0.000104698892814985,0,"0"
"371830525043016","5","5","4","14","5","5","4","14","4","18","18",39,0.00951474551534269,4098.90100971296,"22"
"371830525033023","3","5","3","11","3","5","3","11","4","15","15",0,0.00227573617535113,0,"0"
"371830524011094","1","5","2","8","1","5","3","9","3","11","12",0,0.0133647574950975,0,"0"
"371830525033005","1","5","1","7","1","5","1","7","5","12","12",0,0.000753065736599874,0,"0"
"371830506002041","5","4","5","14","5","4","5","14","3","17","17",0,0.00154135688919943,0,"0"
"371830509001023","4","5","5","14","4","5","5","14","4","18","18",0,0.00310888755681489,0,"0"
"371830521021033","3","4","4","11","3","4","4","11","3","14","14",54,0.00371563203668144,14533.1936711982,"14"
"371830528061033","3","1","1","5","3","2","1","6","4","9","10",0,0.00132406034085514,0,"0"
"371830541054027","3","3","3","9","3","3","3","9","3","12","12",0,0.00877933458719154,0,"0"
"371830537241078","1","5","2","8","1","5","2","8","2","10","10",84,0.00695449139946554,12078.5252544069,"21"
"371830541051019","4","4","2","10","4","4","3","11","4","14","15",13,0.00557859090585461,2330.33757437864,"4"
"371830541053009","3","2","1","6","3","2","2","7","4","10","11",37,0.00234229333461378,15796.4843485758,"20"
"371830541051021","3","2","2","7","3","2","2","7","4","11","11",121,0.00991445523163451,12204.4022765789,"36"
"371830541051009","3","2","2","7","3","2","2","7","4","11","11",97,0.0129949400727035,7464.44381099942,"33"
"371830542071066","1","2","1","4","1","2","1","4","2","6","6",98,0.0208009158055808,4711.33102580546,"27"
"371830536101083","1","5","1","7","1","5","2","8","1","8","9",0,0.000834180101778372,0,"0"
"371830536101004","1","5","1","7","1","5","1","7","1","8","8",0,0.00574329027626969,0,"0"
"371830537252014","4","5","2","11","4","5","2","11","3","14","14",0,0.00352473892891344,0,"0"
"371830538071019","2","1","2","5","2","2","3","7","3","8","10",0,0.0287880503460225,0,"0"
"371830537071011","3","2","3","8","3","2","3","8","3","11","11",24,0.00538787098594869,4454.44964487658,"13"
"371830518003006","3","3","4","10","4","4","5","13","4","14","17",71,0.0117776143156879,6028.3855538916,"39"
"371830503001026","5","5","5","15","5","5","5","15","3","18","18",113,0.00964402768232414,11717.0961886712,"85"
"371830505001011","5","5","5","15","5","5","5","15","3","18","18",44,0.00677936853448481,6490.27999823051,"16"
"371830514001013","5","5","5","15","5","5","5","15","4","19","19",87,0.012564068980259,6924.50830512766,"36"
"371830510002012","5","5","5","15","5","5","5","15","5","20","20",124,0.0101599467760012,12204.7883452402,"57"
"371830527073019","2","3","3","8","2","3","3","8","2","10","10",118,0.0153665550755239,7679.0145494583,"39"
"371830527073023","3","3","3","9","3","3","3","9","2","11","11",110,0.00927958292646853,11853.9810325141,"42"
"371830527073027","3","4","3","10","3","4","4","11","2","12","13",0,0.000586341900706377,0,"0"
"371830541131005","1","1","1","3","1","1","1","3","2","5","5",0,0.0744797051935333,0,"0"
"371830527073016","3","4","3","10","3","4","4","11","2","12","13",92,0.0134547007415094,6837.75891916856,"28"
"371830542091063","3","1","1","5","3","1","1","5","3","8","8",0,0.000242894011902757,0,"0"
"371830536101067","4","1","2","7","4","1","2","7","1","8","8",43,0.00317578364196273,13539.9652016044,"23"
"371830536102033","5","1","2","8","5","1","2","8","1","9","9",31,0.00332091893595947,9334.76564704027,"17"
"371830536102114","4","5","2","11","4","5","2","11","1","12","12",0,0.000403872572712284,0,"0"
"371830521013007","2","3","4","9","2","3","4","9","3","12","12",142,0.0112925455702114,12574.6669886887,"35"
"371830545002035","4","3","4","11","4","3","4","11","3","14","14",0,0.00225016354216184,0,"0"
"371830537241091","3","5","2","10","3","5","2","10","2","12","12",0,0.00832355308324943,0,"0"
"371830537093033","1","5","1","7","1","5","1","7","2","9","9",23,0.0112537165767368,2043.76925997449,"11"
"371830540012007","4","3","4","11","4","3","4","11","3","14","14",32,0.00735049050131147,4353.45096960408,"9"
"371830537142023","3","3","3","9","3","3","3","9","4","13","13",30,0.0521992074192569,574.721369982577,"15"
"371830525071011","2","2","2","6","2","2","2","6","4","10","10",0,0.000458677473626607,0,"0"
"371830537143010","3","3","3","9","3","3","3","9","3","12","12",0,0.000806553798191959,0,"0"
"371830525041009","2","5","4","11","2","5","4","11","5","16","16",0,0.00734298508527034,0,"0"
"371830525042005","3","5","3","11","3","5","4","12","3","14","15",56,0.0116767319497006,4795.86242462609,"39"
"371830515011005","5","2","3","10","5","2","4","11","4","14","15",0,0.00249306629632847,0,"0"
"371830524011032","1","5","3","9","1","5","3","9","5","14","14",0,0.00380907530783143,0,"0"
"371830524011031","1","5","3","9","1","5","3","9","5","14","14",0,0.00926965581419342,0,"0"
"371830524071017","4","5","4","13","4","5","4","13","3","16","16",15,0.00473405089747718,3168.53374094344,"6"
"371830515011022","3","3","4","10","3","3","5","11","4","14","15",0,0.00144595756171979,0,"0"
"371830515012014","3","2","4","9","3","3","4","10","4","13","14",35,0.00837384906672819,4179.67886943001,"12"
"371830514003004","4","5","5","14","4","5","5","14","4","18","18",104,0.0278260329531088,3737.50725355842,"48"
"371830526012023","3","3","4","10","3","3","5","11","4","14","15",0,0.00409009061242404,0,"0"
"371830519002005","4","5","5","14","4","5","5","14","4","18","18",106,0.00708383857157079,14963.6385596652,"37"
"371830536101053","3","1","1","5","3","1","1","5","1","6","6",45,0.0117606012682179,3826.33497843421,"12"
"371830524092002","3","5","5","13","3","5","5","13","5","18","18",0,0.00481008143671422,0,"0"
"371830524071004","3","5","3","11","3","5","4","12","3","14","15",0,0.00868434203883283,0,"0"
"371830524071003","3","5","4","12","3","5","4","12","4","16","16",0,0.00222265210822828,0,"0"
"371830514005021","5","5","5","15","5","5","5","15","3","18","18",42,0.00596279711961167,7043.67416121903,"19"
"371830525052002","2","3","3","8","2","3","3","8","3","11","11",30,0.0565593063326075,530.416689051655,"10"
"371830506002026","5","4","5","14","5","5","5","15","3","17","18",8,0.00349812666708842,2286.93834196079,"4"
"371830511021008","4","5","5","14","4","5","5","14","4","18","18",0,0.00296061799011151,0,"0"
"371830526011006","3","4","3","10","3","4","4","11","5","15","16",62,0.0391179243990313,1584.95116886967,"24"
"371830537241083","2","5","2","9","2","5","2","9","3","12","12",0,0.000745341403784509,0,"0"
"371830536101081","1","5","1","7","1","5","1","7","1","8","8",73,0.00513470082589026,14216.9918901445,"40"
"371830537093009","2","5","1","8","2","5","1","8","2","10","10",45,0.00732744955193711,6141.2910018744,"25"
"371830537232006","4","1","3","8","4","1","3","8","3","11","11",88,0.0138712230654169,6344.06927096413,"43"
"371830537071014","3","2","3","8","3","2","3","8","3","11","11",0,0.00376068865716695,0,"0"
"371830525043039","4","5","3","12","4","5","4","13","3","15","16",0,0.00030349766128175,0,"0"
"371830525032007","3","5","2","10","3","5","3","11","3","13","14",22,0.0143687591685592,1531.09950148924,"9"
"371830530081015","2","4","2","8","2","4","3","9","3","11","12",128,0.0196751560867484,6505.66630504195,"68"
"371830527052039","2","3","4","9","3","3","5","11","5","14","16",0,0.000149876183197708,0,"0"
"371830520011009","2","2","3","7","5","3","5","13","3","10","16",0,9.75326167674033e-05,0,"0"
"371830524062019","2","4","3","9","4","4","3","11","3","12","14",0,0.00034580647721653,0,"0"
"371830545002056","1","2","3","6","1","2","3","6","2","8","8",0,0.000139157377360593,0,"0"
"371830521021031","3","3","4","10","3","3","4","10","3","13","13",0,0.0320966332182761,0,"0"
"371830542071021","1","4","1","6","1","4","1","6","2","8","8",817,0.220494194639909,3705.31297358757,"354"
"371830527071010","3","4","3","10","3","4","3","10","2","12","12",0,0.00117610101050748,0,"0"
"371830541062043","3","2","2","7","3","3","2","8","5","12","13",34,0.0151445341341341,2245.03439319191,"11"
"371830527062001","5","3","4","12","5","3","4","12","3","15","15",38,0.00855123469949401,4443.80271801551,"11"
"371830541052036","1","2","2","5","1","2","2","5","4","9","9",12,0.00268662352852468,4466.57295768925,"5"
"371830540071013","2","1","2","5","3","1","3","7","5","10","12",38,0.00869760823066871,4369.01720475382,"14"
"371830540061000","1","4","3","8","1","4","4","9","3","11","12",28,0.0198709991074805,1409.08868489956,"11"
"371830515011008","5","3","4","12","5","3","5","13","4","16","17",0,0.00616439500118018,0,"0"
"371830505001025","5","4","5","14","5","4","5","14","3","17","17",134,0.0242231515294816,5531.89785552515,"64"
"371830519001004","2","3","4","9","3","3","5","11","5","14","16",0,0.0038878617656109,0,"0"
"371830524063008","1","5","2","8","2","5","2","9","2","10","11",0,0.00665084132070491,0,"0"
"371830524041022","3","5","3","11","3","5","4","12","4","15","16",0,0.0117634303852817,0,"0"
"371830523021040","5","5","5","15","5","5","5","15","5","20","20",0,0.001179856122706,0,"0"
"371830545001003","5","5","5","15","5","5","5","15","5","20","20",73,0.00175425370667656,41613.1370976542,"28"
"371830528033071","1","1","2","4","1","1","2","4","3","7","7",0,0.0038465987931624,0,"0"
"371830528064037","1","1","1","3","1","2","1","4","5","8","9",56,0.00688095694878732,8138.40290192039,"20"
"371830528072029","3","1","1","5","3","2","1","6","2","7","8",11,0.00183039627249558,6009.62762287672,"4"
"371830537163003","3","3","4","10","3","3","4","10","4","14","14",70,0.00887145938528308,7890.4717882295,"43"
"371830537262011","2","5","2","9","2","5","2","9","3","12","12",0,0.00438582313832946,0,"0"
"371830537262008","1","5","2","8","1","5","2","8","3","11","11",0,0.00045380548277324,0,"0"
"371830541052030","1","3","2","6","1","3","3","7","3","9","10",37,0.00550251212349053,6724.20145010584,"15"
"371830527063014","2","3","3","8","2","3","4","9","3","11","12",0,0.00437870884578264,0,"0"
"371830540012010","2","2","3","7","2","2","4","8","2","9","10",164,0.0514829972666837,3185.51771860668,"62"
"371830537091009","1","5","2","8","1","5","2","8","2","10","10",38,0.0052667275509181,7215.10646461593,"21"
"371830540072010","2","2","3","7","3","2","3","8","4","11","12",0,0.000800372058391058,0,"0"
"371830525051032","3","3","3","9","3","3","4","10","5","14","15",0,0.000817090144074331,0,"0"
"371830524011071","2","5","3","10","3","5","4","12","4","14","16",54,0.0118444303188806,4559.10487429026,"32"
"371830525031011","2","5","2","9","2","5","2","9","3","12","12",302,0.010849317860114,27835.8514234579,"151"
"371830527041006","2","3","4","9","2","3","4","9","2","11","11",0,0.0269910981517867,0,"0"
"371830515022024","4","4","4","12","4","5","5","14","4","16","18",174,0.0483677717408178,3597.43675876556,"68"
"371830526031005","4","3","4","11","4","3","4","11","4","15","15",93,0.0628821921636595,1478.95607325449,"31"
"371830524062021","1","2","2","5","4","2","2","8","3","8","11",22,0.0111264171904838,1977.27620880656,"10"
"371830505002018","4","4","5","13","5","5","5","15","3","16","18",0,0.00300248538011596,0,"0"
"371830505002009","5","5","5","15","5","5","5","15","4","19","19",33,0.00745595108831063,4425.9946999568,"17"
"371830541043028","1","2","3","6","5","3","4","12","2","8","14",229,0.0217774331854696,10515.4725099923,"68"
"371830536101065","4","1","1","6","4","1","1","6","1","7","7",43,0.00232510425712821,18493.7943613377,"23"
"371830540163016","2","4","2","8","2","5","3","10","5","13","15",138,0.038022616832645,3629.41879059512,"74"
"371830528033003","1","2","2","5","4","3","3","10","3","8","13",142,0.0178346216698556,7962.04161930787,"46"
"371830521012016","5","4","5","14","5","4","5","14","3","17","17",23,0.00504838496675072,4555.91246536879,"10"
"371830528033055","1","1","2","4","1","2","2","5","3","7","8",97,0.00653446368497709,14844.3705063364,"28"
"371830525043028","4","5","3","12","4","5","4","13","3","15","16",18,0.00147824333250755,12176.6150431178,"13"
"371830525043024","4","5","3","12","4","5","4","13","3","15","16",36,0.00153697105932562,23422.6921720933,"26"
"371830525041012","2","1","3","6","2","1","4","7","4","10","11",0,0.00374438584751887,0,"0"
"371830525032015","2","1","2","5","2","1","2","5","4","9","9",57,0.00371403132122453,15347.204982969,"26"
"371830525043041","4","5","3","12","4","5","4","13","3","15","16",25,0.00243633574899425,10261.3114839858,"17"
"371830508002010","5","5","5","15","5","5","5","15","5","20","20",165,0.0204780827737775,8057.39491449293,"55"
"371830517003010","4","3","4","11","4","3","5","12","4","15","16",42,0.01501397712025,2797.39336643538,"18"
"371830526031008","5","3","4","12","5","3","5","13","5","17","18",13,0.00517026915804039,2514.37586760516,"4"
"371830516003009","4","4","5","13","4","4","5","13","3","16","16",30,0.0126484652761786,2371.82925714318,"13"
"371830541053005","1","2","2","5","1","2","2","5","4","9","9",22,0.00590006583823293,3728.77194987183,"7"
"371830541063034","3","3","2","8","3","3","2","8","4","12","12",117,0.0179840797684282,6505.75406173401,"37"
"371830538082018","1","2","2","5","3","2","3","8","4","9","12",52,0.0515649253987308,1008.43741356949,"17"
"371830537191004","1","1","1","3","3","1","1","5","1","4","6",51,0.00401598070425942,12699.2642036124,"17"
"371830537171008","1","5","1","7","1","5","1","7","2","9","9",273,0.0468495589353769,5827.16265005973,"108"
"371830542091046","1","1","1","3","1","1","1","3","3","6","6",61,0.00736402523926625,8283.51316271127,"21"
"371830525062006","3","2","2","7","3","2","3","8","4","11","12",9,0.0330206716004431,272.55654000324,"4"
"371830525062001","4","2","2","8","4","2","3","9","3","11","12",8,0.0129416513144644,618.159136389239,"3"
"371830537143006","2","2","3","7","2","2","3","7","3","10","10",103,0.0151820027168326,6784.34867395997,"38"
"371830540071005","3","2","3","8","4","2","3","9","4","12","13",7,0.00101489018082926,6897.29798575874,"2"
"371830537073008","4","4","3","11","4","4","4","12","5","16","17",45,0.00748564093400041,6011.50928781612,"28"
"371830524062028","2","5","3","10","3","5","4","12","3","13","15",0,0.00771911918311187,0,"0"
"371830525033033","2","5","3","10","2","5","4","11","5","15","16",0,6.84463823440785e-05,0,"0"
"371830525043035","5","5","4","14","5","5","5","15","5","19","20",67,0.016185032982559,4139.62702900879,"26"
"371830524011016","1","5","2","8","1","5","2","8","4","12","12",0,0.00787382780684812,0,"0"
"371830525043029","4","5","3","12","4","5","3","12","3","15","15",94,0.00475810790739436,19755.7520404106,"50"
"371830524012009","2","3","3","8","2","3","4","9","3","11","12",0,0.00712735270807744,0,"0"
"371830537181001","1","1","1","3","5","1","2","8","1","4","9",9,0.00568383557177912,1583.43778357805,"2"
"371830537111016","3","5","2","10","3","5","2","10","2","12","12",137,0.0536278311158576,2554.64368312836,"44"
"371830527043011","4","3","4","11","4","3","4","11","2","13","13",60,0.0129426923552511,4635.82061236717,"24"
"371830540143034","1","3","2","6","1","4","2","7","2","8","9",61,0.00629956334570719,9683.21082786923,"21"
"371830517001020","5","4","5","14","5","4","5","14","4","18","18",75,0.0264919984228077,2831.04350238185,"26"
"371830516003015","4","4","5","13","4","5","5","14","3","16","17",38,0.00502061560923005,7568.79294446276,"9"
"371830503001000","4","4","5","13","4","5","5","14","3","16","17",41,0.00914454872562304,4483.54546847325,"19"
"371830545002043","2","3","4","9","2","3","4","9","3","12","12",0,0.0157732849246701,0,"0"
"371830503001017","5","5","5","15","5","5","5","15","3","18","18",28,0.00481094721046302,5820.05970448077,"22"
"371830511012011","3","4","4","11","3","4","5","12","5","16","17",117,0.0411988315232059,2839.88636750772,"44"
"371830541062056","2","1","2","5","2","2","3","7","3","8","10",0,0.00012887298414692,0,"0"
"371830545002003","3","5","5","13","3","5","5","13","4","17","17",0,0.00308410606841534,0,"0"
"371830527073031","2","3","3","8","2","3","3","8","2","10","10",109,0.0306266038685634,3558.99728444533,"39"
"371830541053008","5","3","2","10","5","3","2","10","5","15","15",0,0.0086660426239889,0,"0"
"371830541062051","4","3","2","9","4","4","3","11","5","14","16",23,0.0189709495288372,1212.3800110816,"11"
"371830541102051","1","1","1","3","1","1","1","3","3","6","6",64,0.00900183803340563,7109.65913433428,"21"
"371830537141005","3","2","2","7","3","2","3","8","4","11","12",60,0.0139384325831188,4304.64470392944,"27"
"371830525072003","2","5","2","9","2","5","2","9","3","12","12",0,0.000520956168349957,0,"0"
"371830540012006","4","3","4","11","4","3","4","11","3","14","14",62,0.0160721731251157,3857.59906375782,"25"
"371830537152009","3","3","3","9","3","3","3","9","4","13","13",77,0.014602829187914,5272.95081036276,"26"
"371830518001008","3","4","5","12","5","4","5","14","4","16","18",0,0.0162719692701925,0,"0"
"371830515021007","3","5","4","12","3","5","5","13","4","16","17",0,0.0010122593027809,0,"0"
"371830518001005","2","3","4","9","3","3","5","11","5","14","16",0,0.000335461360158765,0,"0"
"371830504002006","5","4","5","14","5","4","5","14","3","17","17",106,0.00474930771984043,22319.0423221432,"100"
"371830524071019","4","5","4","13","4","5","4","13","3","16","16",389,0.0689210025863081,5644.14308269623,"189"
"371830524062022","1","2","2","5","4","2","2","8","3","8","11",31,0.0139791222309784,2217.59274207522,"11"
"371830524072013","4","5","4","13","4","5","4","13","4","17","17",0,0.00311384551367488,0,"0"
"371830524063019","1","2","2","5","4","2","3","9","2","7","11",54,0.00360950283211304,14960.5091093357,"29"
"371830545002048","1","2","3","6","1","2","3","6","2","8","8",0,0.0125287353670219,0,"0"
"371830521013010","3","3","4","10","3","3","5","11","3","13","14",57,0.0113703559923505,5013.03565502673,"16"
"371830528061003","3","1","1","5","3","1","1","5","3","8","8",18,0.0105787695821786,1701.52113250708,"7"
"371830528072058","1","1","1","3","1","1","1","3","2","5","5",14,0.00723298422072046,1935.57729047631,"4"
"371830528062013","1","1","2","4","5","3","3","11","4","8","15",128,0.009606260858364,13324.6433640778,"39"
"371830528064002","1","1","1","3","1","1","1","3","4","7","7",49,0.0132828280459197,3688.97344982586,"10"
"371830521021043","2","2","4","8","2","3","4","9","3","11","12",0,0.0178507815484595,0,"0"
"371830541062004","3","3","3","9","3","4","4","11","3","12","14",0,0.0290869346595421,0,"0"
"371830535211071","1","5","2","8","1","5","2","8","2","10","10",0,0.00824553222523933,0,"0"
"371830524072002","3","5","4","12","4","5","4","13","3","15","16",16,0.011160121072921,1433.6762025658,"8"
"371830518001014","4","4","5","13","4","4","5","13","4","17","17",139,0.0227845996525405,6100.61190978623,"66"
"371830504001032","5","4","5","14","5","5","5","15","3","17","18",65,0.0106215250694458,6119.64850386516,"26"
"371830521021010","5","5","4","14","5","5","4","14","5","19","19",0,0.00032077606287895,0,"0"
"371830509002011","5","5","5","15","5","5","5","15","5","20","20",0,0.0031178551712302,0,"0"
"371830545001028","4","4","4","12","4","4","5","13","4","16","17",2,0.00415772265407287,481.032566720345,"1"
"371830523021011","3","5","4","12","3","5","4","12","4","16","16",9,0.0180042082197283,499.883132330038,"4"
"371830527061015","3","3","4","10","3","3","4","10","3","13","13",0,0.0230147905411169,0,"0"
"371830540181008","2","2","3","7","2","3","3","8","2","9","10",13,0.0180998486799893,718.238048828135,"7"
"371830537093037","1","5","1","7","1","5","1","7","2","9","9",38,0.00668837065035829,5681.50331171679,"17"
"371830541102049","1","1","1","3","2","2","2","6","3","6","9",46,0.00479410652499575,9595.11428462487,"15"
"371830542091053","2","1","1","4","2","1","1","4","3","7","7",78,0.0112802873669604,6914.71745910121,"35"
"371830542071023","1","2","1","4","1","2","1","4","2","6","6",170,0.0340507757327446,4992.54411512632,"55"
"371830542071064","2","4","1","7","2","5","1","8","3","10","11",106,0.0131971255308711,8032.05211256356,"27"
"371830541102036","1","1","1","3","2","2","2","6","2","5","8",40,0.00209991375664924,19048.4013323608,"14"
"371830540132006","5","5","2","12","5","5","3","13","5","17","18",2,0.000478853919457547,4176.63909332857,"1"
"371830504001016","3","4","5","12","4","5","5","14","4","16","18",0,0.00273941418356465,0,"0"
"371830537232018","2","2","3","7","2","2","3","7","4","11","11",6,0.000620117324291582,9675.58841684412,"4"
"371830537092006","2","5","2","9","2","5","2","9","3","12","12",21,0.00151760194279638,13837.6206617822,"12"
"371830537143011","2","2","3","7","2","2","3","7","3","10","10",3,0.000323966007318821,9260.23080269542,"2"
"371830537071007","3","2","3","8","3","2","3","8","3","11","11",1,0.00051314835923819,1948.75416046264,"1"
"371830537223006","4","2","2","8","4","2","2","8","3","11","11",0,0.000150808098206305,0,"0"
"371830537121003","3","1","2","6","3","1","2","6","3","9","9",34,0.0172909917398801,1966.34181031862,"11"
"371830540042004","4","2","4","10","4","3","4","11","2","12","13",110,0.0238297877402211,4616.07133051952,"46"
"371830527012005","2","3","4","9","2","3","4","9","2","11","11",5,0.0586552177688907,85.2439082180321,"2"
"371830540134036","1","4","2","7","1","4","2","7","5","12","12",14,0.00519797051203204,2693.35887296655,"10"
"371830540134011","3","5","3","11","3","5","3","11","5","16","16",120,0.00329536036609049,36414.8337871661,"77"
"371830527042005","4","2","4","10","4","2","4","10","2","12","12",107,0.00666037976024741,16065.1500142126,"35"
"371830511012007","4","4","4","12","4","5","5","14","5","17","19",161,0.0125915715550855,12786.3308639163,"65"
"371830524081011","5","5","4","14","5","5","5","15","4","18","19",177,0.0141182878293516,12536.9309748751,"92"
"371830501001018","5","5","5","15","5","5","5","15","4","19","19",63,0.00827122682901288,7616.76608589861,"30"
"371830509001015","5","5","5","15","5","5","5","15","5","20","20",1,0.0175029687284232,57.1331649799551,"1"
"371830509002002","5","5","5","15","5","5","5","15","4","19","19",37,0.00384921976235583,9612.33763835685,"11"
"371830509002022","5","5","5","15","5","5","5","15","5","20","20",18,0.00475599582710761,3784.69634001904,"8"
"371830540151018","4","3","3","10","4","4","3","11","3","13","14",0,0.00392375348422826,0,"0"
"371830527012021","4","3","4","11","4","3","4","11","3","14","14",0,0.0186864999162476,0,"0"
"371830540131016","2","5","2","9","2","5","2","9","3","12","12",76,0.00635337571694849,11962.1447535772,"21"
"371830540162025","1","3","2","6","1","4","2","7","2","8","9",0,0.000182259209618771,0,"0"
"371830511012000","5","4","4","13","5","4","5","14","5","18","19",255,0.0484363918801974,5264.63656976592,"119"
"371830530081063","1","2","2","5","4","2","3","9","2","7","11",31,0.0148179679746128,2092.05473065615,"16"
"371830520012018","3","4","5","12","5","4","5","14","3","15","17",11,0.00703841078733171,1562.85279907201,"4"
"371830528062023","3","2","2","7","3","3","3","9","3","10","12",0,0.00626742992586094,0,"0"
"371830528072076","4","2","2","8","4","5","2","11","2","10","13",90,0.0189082819274365,4759.81902244683,"32"
"371830537092002","1","5","2","8","1","5","2","8","3","11","11",0,0.000668615436755234,0,"0"
"371830516004010","5","4","4","13","5","4","5","14","3","16","17",48,0.014497124419462,3311.00145181629,"23"
"371830524071026","5","5","4","14","5","5","4","14","3","17","17",60,0.0214942417439041,2791.44529566932,"25"
"371830524072015","4","5","3","12","4","5","4","13","4","16","17",0,0.00272906358021935,0,"0"
"371830524041011","4","5","4","13","4","5","4","13","4","17","17",24,0.0098233195407347,2443.16596853827,"13"
"371830519001028","3","4","4","11","5","4","5","14","4","15","18",0,0.00270137214427417,0,"0"
"371830505003011","5","5","5","15","5","5","5","15","4","19","19",25,0.00566663965430182,4411.78573637046,"10"
"371830519002016","4","4","5","13","4","4","5","13","4","17","17",12,0.00545050138035111,2201.63232014942,"9"
"371830524063009","1","2","2","5","3","2","2","7","2","7","9",869,0.128699522843086,6752.16178586385,"437"
"371830528072077","3","1","1","5","3","3","2","8","2","7","10",310,0.061740352016464,5021.02741360033,"113"
"371830528064033","1","1","1","3","1","2","1","4","4","7","8",63,0.00628337790377948,10026.4540768915,"22"
"371830523022006","3","5","3","11","5","5","4","14","3","14","17",157,0.00555947857813741,28240.0584503376,"51"
"371830504001019","4","4","5","13","5","5","5","15","3","16","18",0,0.00320252204923114,0,"0"
"371830515022022","5","5","5","15","5","5","5","15","4","19","19",0,0.000493560359201914,0,"0"
"371830516002023","5","4","4","13","5","4","5","14","3","16","17",54,0.0299192253470987,1804.85956349255,"22"
"371830521011000","5","4","4","13","5","4","5","14","3","16","17",39,0.0102482812464527,3805.51617018701,"18"
"371830528033043","1","1","1","3","1","1","1","3","2","5","5",0,0.0136106717055056,0,"0"
"371830523013013","3","5","3","11","3","5","4","12","4","15","16",297,0.0109381718244995,27152.6178931269,"144"
"371830523013003","2","5","3","10","2","5","4","11","4","14","15",39,0.088187385302561,442.240121602374,"19"
"371830530082003","3","5","3","11","3","5","3","11","3","14","14",1,0.00210140712549061,475.871613772381,"1"
"371830537122015","3","2","3","8","3","2","3","8","4","12","12",128,0.0468720487322113,2730.83860130134,"43"
"371830540134014","1","4","1","6","1","4","1","6","5","11","11",109,0.0155403218277783,7014.01175651093,"28"
"371830540163014","2","5","3","10","2","5","3","10","4","14","14",3,0.00633554191822147,473.51908309087,"2"
"371830540141056","1","3","1","5","3","4","2","9","3","8","12",0,0.00175330511587552,0,"0"
"371830518003009","4","4","5","13","4","4","5","13","5","18","18",242,0.0300953947686123,8041.09737920406,"124"
"371830518001028","5","4","5","14","5","5","5","15","3","17","18",38,0.00790777471839411,4805.39739095108,"18"
"371830518001022","4","4","5","13","4","4","5","13","3","16","16",45,0.0158384883082082,2841.18023919487,"25"
"371830505001019","5","4","5","14","5","5","5","15","3","17","18",41,0.00692325878566167,5922.06665521626,"16"
"371830505001022","5","4","5","14","5","5","5","15","4","18","19",20,0.00365396704059654,5473.50312079849,"12"
"371830520011011","3","2","4","9","4","3","5","12","3","12","15",0,0.000576668939928077,0,"0"
"371830545001001","4","5","5","14","4","5","5","14","4","18","18",0,0.00269065512923191,0,"0"
"371830541054015","2","3","2","7","3","3","3","9","3","10","12",115,0.00792997376377675,14501.9395304064,"42"
"371830527061001","4","3","3","10","4","3","4","11","3","13","14",0,0.00461014235584608,0,"0"
"371830541063009","3","3","2","8","3","3","2","8","4","12","12",92,0.0133453372070602,6893.79358292487,"27"
"371830523013024","3","5","3","11","3","5","4","12","4","15","16",30,0.00384638727061351,7799.52664392395,"20"
"371830530081016","2","4","2","8","2","4","2","8","3","11","11",6,0.0232234114336714,258.359975111179,"4"
"371830541041013","1","3","1","5","3","4","2","9","5","10","14",133,0.0532460035040282,2497.84004897078,"46"
"371830523012005","3","5","4","12","3","5","4","12","5","17","17",0,0.000183162259903636,0,"0"
"371830540012011","3","2","3","8","3","2","4","9","2","10","11",78,0.016848037686819,4629.61927376403,"29"
"371830540013004","3","4","4","11","3","4","4","11","3","14","14",0,0.0073195451074562,0,"0"
"371830525071009","2","2","2","6","2","2","2","6","4","10","10",30,0.00352260954675679,8516.41364215926,"24"
"371830505001023","5","4","5","14","5","5","5","15","3","17","18",52,0.00870311439105458,5974.87263334695,"24"
"371830525052018","3","3","3","9","3","3","4","10","4","13","14",0,0.00299679712642572,0,"0"
"371830537071021","2","2","2","6","2","2","3","7","3","9","10",17,0.0046643283352299,3644.68338808788,"6"
"371830537231004","3","2","3","8","3","2","3","8","3","11","11",39,0.00298626179342096,13059.8061047163,"18"
"371830537071016","2","2","2","6","2","2","3","7","3","9","10",22,0.0051896551708393,4239.20265909344,"11"
"371830541042005","3","3","2","8","3","3","2","8","4","12","12",108,0.0146345836518713,7379.77947095135,"31"
"371830524041012","4","5","4","13","4","5","4","13","4","17","17",34,0.0121859944131545,2790.08826422059,"14"
"371830524041025","4","5","4","13","4","5","4","13","4","17","17",40,0.0145491154868626,2749.30802742742,"15"
"371830501001004","4","5","5","14","4","5","5","14","4","18","18",0,0.0123421974252123,0,"0"
"371830521014004","4","4","5","13","4","5","5","14","5","18","19",0,0.0038191710569777,0,"0"
"371830528064004","1","1","1","3","1","2","1","4","4","7","8",76,0.020950997424121,3627.5122592732,"23"
"371830530081030","5","5","3","13","5","5","4","14","5","18","19",0,0.00309795854800963,0,"0"
"371830537093042","1","5","1","7","1","5","1","7","3","10","10",5,0.00801418987448623,623.893378907564,"1"
"371830505001013","5","5","5","15","5","5","5","15","3","18","18",43,0.00772712091763444,5564.81520845204,"23"
"371839802001005","1","5","1","7","1","5","1","7","2","9","9",0,0.00840894759650818,0,"0"
"371830537261013","4","5","2","11","4","5","3","12","4","15","16",251,0.0145623037134118,17236.2838284186,"113"
"371830537142003","2","2","3","7","2","2","3","7","4","11","11",188,0.0420333403854188,4472.64001090945,"95"
"371830537071027","4","3","3","10","4","3","3","10","3","13","13",51,0.0243039169579661,2098.4271830835,"23"
"371830525042000","2","5","4","11","2","5","4","11","4","15","15",0,0.00918111566103708,0,"0"
"371830537171021","1","5","1","7","2","5","1","8","1","8","9",93,0.00653154201486183,14238.5978362213,"55"
"371830541055002","3","3","2","8","3","3","3","9","4","12","13",228,0.179939426477455,1267.09306828077,"88"
"371830525041015","3","5","4","12","3","5","5","13","4","16","17",0,0.00586741519186712,0,"0"
"371830525032006","2","5","2","9","2","5","2","9","3","12","12",65,0.0255736092547489,2541.68269142259,"28"
"371830525033035","2","5","3","10","2","5","4","11","5","15","16",0,0.0138020211422325,0,"0"
"371830524011025","1","5","3","9","1","5","3","9","5","14","14",0,0.00461920349520316,0,"0"
"371830515011002","5","4","4","13","5","4","5","14","5","18","19",0,0.00389201098976681,0,"0"
"371830524011012","1","5","2","8","1","5","3","9","5","13","14",0,0.00678986538301535,0,"0"
"371830512003008","5","5","5","15","5","5","5","15","4","19","19",291,0.0259215618104329,11226.1754182913,"140"
"371830542071085","2","4","1","7","2","5","1","8","3","10","11",176,0.0917755632394749,1917.72181817892,"54"
"371830505001012","5","5","5","15","5","5","5","15","3","18","18",6,0.00398585039401817,1505.32493868927,"4"
"371830541101001","4","2","1","7","4","3","2","9","4","11","13",53,0.0124589516801835,4253.96946392356,"25"
"371830536101075","1","5","1","7","1","5","1","7","1","8","8",66,0.00242550632060768,27210.8134451138,"36"
"371830537112009","3","5","2","10","3","5","2","10","3","13","13",27,0.00541211466874935,4988.80782329012,"11"
"371830537251024","2","5","2","9","2","5","2","9","3","12","12",83,0.0125601662757256,6608.19277212992,"52"
"371830537241046","3","5","2","10","3","5","2","10","2","12","12",48,0.00455783748175802,10531.3101206684,"24"
"371830537132005","4","2","3","9","4","2","3","9","4","13","13",23,0.00129026237813269,17825.8316988877,"17"
"371830537211021","3","1","1","5","3","1","2","6","3","8","9",36,0.0144944724195665,2483.70544010988,"11"
"371830540141090","1","3","2","6","2","4","3","9","3","9","12",74,0.00846719886388431,8739.60812655966,"24"
"371830527012022","3","2","4","9","3","3","4","10","3","12","13",106,0.0448654077472966,2362.62201375818,"34"
"371830540143001","2","2","2","6","2","3","2","7","3","9","10",24,0.00339226535549451,7074.91822864823,"12"
"371830512003010","5","5","5","15","5","5","5","15","4","19","19",90,0.00475829520220991,18914.3372101422,"25"
"371830540141039","2","2","1","5","3","4","2","9","4","9","13",103,0.00618194821008614,16661.4142499529,"42"
"371830540131026","1","5","1","7","1","5","2","8","4","11","12",10,0.0148158656971868,674.952122568091,"3"
"371830504001024","4","4","5","13","4","4","5","13","3","16","16",43,0.00791315553064513,5433.98898624887,"22"
"371830505002013","4","4","5","13","5","5","5","15","3","16","18",8,0.00813044639492936,983.955813913155,"3"
"371830536101070","4","1","1","6","4","1","1","6","1","7","7",38,0.00216589590643651,17544.702811928,"23"
"371830520011015","3","3","4","10","4","3","5","12","3","13","15",0,0.000820652328167603,0,"0"
"371830501001052","5","5","5","15","5","5","5","15","5","20","20",0,0.0105379128540912,0,"0"
"371830509001026","5","5","5","15","5","5","5","15","5","20","20",0,0.00320984302721335,0,"0"
"371830521021005","4","3","4","11","4","4","4","12","4","15","16",148,0.00411328784933531,35980.9489199537,"53"
"371830524063015","1","2","2","5","4","2","3","9","2","7","11",22,0.000582125302294269,37792.5506987821,"11"
"371830511011001","3","5","5","13","3","5","5","13","5","18","18",2097,0.053739549203894,39021.5405798017,"0"
"371830528072046","1","1","2","4","1","1","2","4","2","6","6",0,0.0161799230393448,0,"0"
"371830545002010","5","4","4","13","5","4","5","14","4","17","18",51,0.0105221016862576,4846.94042318641,"21"
"371830537151006","4","4","3","11","4","4","3","11","5","16","16",405,0.17656134634402,2293.82029751223,"170"
"371830541051036","5","3","2","10","5","4","3","12","5","15","17",0,0.00250996779788106,0,"0"
"371830541063033","5","4","3","12","5","4","3","12","5","17","17",3,0.00167975380609826,1785.97600976325,"1"
"371830527062022","2","1","3","6","2","1","4","7","3","9","10",0,0.0033080196128924,0,"0"
"371830530081040","2","4","2","8","2","4","2","8","3","11","11",0,0.000380610807565104,0,"0"
"371830521014022","4","5","5","14","4","5","5","14","5","19","19",0,0.00295213757571555,0,"0"
"371830520022011","4","4","5","13","4","4","5","13","5","18","18",42,0.00997076923547922,4212.31291268385,"18"
"371830519001000","2","3","4","9","3","3","5","11","5","14","16",0,0.00184437760389182,0,"0"
"371830520021013","4","4","4","12","4","5","5","14","5","17","19",71,0.0170162439995168,4172.48365749903,"30"
"371830517001002","5","4","5","14","5","5","5","15","5","19","20",77,0.0151254768064067,5090.74860816191,"23"
"371830517001001","5","3","4","12","5","4","5","14","5","17","19",48,0.0153445773634261,3128.140897149,"19"
"371830519003001","3","2","4","9","3","3","5","11","4","13","15",108,0.0304330306307897,3548.77571380401,"46"
"371830541044005","2","2","3","7","4","3","3","10","2","9","12",0,0.0229106070000082,0,"0"
"371830501001107","5","5","5","15","5","5","5","15","5","20","20",36,0.00473202386780039,7607.73846576857,"15"
"371830541061001","2","2","2","6","2","2","2","6","3","9","9",186,0.0151050418405351,12313.7692674813,"59"
"371830527073045","1","2","2","5","1","2","3","6","3","8","9",0,0.00129001380243851,0,"0"
"371830542081125","3","5","1","9","3","5","1","9","4","13","13",107,0.0135636964433436,7888.70500360621,"40"
"371830505002022","4","5","5","14","4","5","5","14","3","17","17",41,0.0105304972828359,3893.45335730987,"22"
"371830505002010","5","5","5","15","5","5","5","15","4","19","19",39,0.00974858593384896,4000.58021385281,"24"
"371830505001015","5","4","5","14","5","5","5","15","3","17","18",29,0.00750193825821902,3865.66764505533,"18"
"371830503001020","5","5","5","15","5","5","5","15","3","18","18",0,0.00068151028651071,0,"0"
"371830527061036","2","2","4","8","2","2","4","8","4","12","12",0,0.00328728308490186,0,"0"
"371830524043006","3","5","4","12","3","5","4","12","4","16","16",107,0.0335569619721062,3188.60807748158,"41"
"371830524041029","4","5","4","13","4","5","4","13","5","18","18",10,0.00307467034664211,3252.38118971718,"5"
"371830530081036","3","5","3","11","3","5","3","11","3","14","14",0,0.00101795442367139,0,"0"
"371830518001003","2","3","4","9","3","3","5","11","5","14","16",0,0.0502528061759711,0,"0"
"371830527061007","3","2","3","8","3","2","4","9","3","11","12",667,0.11335324136465,5884.26049374542,"233"
"371830537132016","4","3","3","10","4","3","3","10","4","14","14",0,0.00303854362392661,0,"0"
"371830526012013","3","3","4","10","3","3","5","11","3","13","14",0,0.0329941661394837,0,"0"
"371830511011005","4","5","4","13","4","5","5","14","5","18","19",0,0.00847450659455344,0,"0"
"371830545001042","5","5","5","15","5","5","5","15","5","20","20",12,0.00756631941859388,1585.97586701277,"4"
"371830521021001","4","5","4","13","4","5","4","13","5","18","18",15,0.00628006429869089,2388.51057673515,"6"
"371830505002005","4","4","5","13","5","4","5","14","3","16","17",6,0.0139841244564253,429.057966317167,"4"
"371830514004015","4","5","5","14","4","5","5","14","5","19","19",1035,0.0169980459015161,60889.351987671,"0"
"371830514005002","5","4","5","14","5","4","5","14","3","17","17",84,0.0108307774674251,7755.67592009348,"49"
"371830520011016","3","2","4","9","4","3","5","12","3","12","15",0,7.43176894591629e-06,0,"0"
"371830527012036","2","2","4","8","2","2","4","8","3","11","11",38,0.0096000739749438,3958.30283174692,"16"
"371830527052003","5","3","4","12","5","3","5","13","3","15","16",87,0.0105316822498645,8260.78853652454,"27"
"371830514004010","5","5","5","15","5","5","5","15","5","20","20",47,0.049839563492314,943.025915691419,"23"
"371830541101010","2","1","1","4","2","2","1","5","3","7","8",224,0.0400556010237943,5592.22666180784,"73"
"371830542081119","2","4","1","7","2","5","1","8","3","10","11",0,0.00359251639855849,0,"0"
"371830537252041","1","5","2","8","1","5","2","8","3","11","11",109,0.00920085796371341,11846.7212981525,"63"
"371830537252017","5","5","3","13","5","5","3","13","4","17","17",4,0.00319178226587489,1253.218317166,"2"
"371830540112009","2","4","3","9","2","4","3","9","3","12","12",89,0.0231621416792779,3842.47714362374,"34"
"371830540112002","3","4","3","10","3","4","3","10","4","14","14",63,0.0170692162997342,3690.85486373391,"22"
"371830540171035","2","4","3","9","2","4","3","9","2","11","11",85,0.0172440933659513,4929.22406508386,"33"
"371830524061005","2","4","2","8","4","4","3","11","3","11","14",50,0.0286207188789285,1746.98616801033,"28"
"371830524011014","2","5","1","8","2","5","2","9","3","11","12",0,0.0035123233035402,0,"0"
"371830523023001","3","5","4","12","5","5","4","14","3","15","17",476,0.0449607864321359,10587.0034261629,"192"
"371830541063001","3","3","2","8","3","3","2","8","4","12","12",196,0.0264528674119297,7409.40469506938,"59"
"371830527052020","4","2","4","10","4","2","4","10","3","13","13",85,0.0124267652808493,6840.07447464968,"24"
"371830527072028","3","3","4","10","3","3","4","10","3","13","13",6,0.0033770961714514,1776.6743069746,"3"
"371830528072025","3","1","1","5","3","2","1","6","2","7","8",4,0.00164061196100708,2438.11461519799,"1"
"371830541131013","4","1","1","6","4","2","1","7","4","10","11",0,0.000413964008581803,0,"0"
"371830527063029","1","3","4","8","2","3","4","9","4","12","13",0,0.00417099090607498,0,"0"
"371830541061030","1","2","2","5","1","2","3","6","2","7","8",45,0.0156055971968485,2883.58077120481,"28"
"371830515011037","2","3","4","9","4","3","5","12","4","13","16",0,0.00117536067266991,0,"0"
"371830545002036","2","2","3","7","2","2","3","7","3","10","10",0,0.000510242154898547,0,"0"
"371830523023035","3","5","3","11","3","5","3","11","2","13","13",1,0.000736844110180114,1357.13916442321,"1"
"371830530081053","1","3","2","6","1","3","2","6","3","9","9",1,0.0111393728941187,89.7716603533374,"1"
"371830523011013","4","5","3","12","4","5","3","12","4","16","16",35,0.00231725666548853,15104.0670294592,"21"
"371830523011014","4","5","2","11","4","5","3","12","4","15","16",2,0.000560568184762888,3567.80861697667,"1"
"371830504001015","3","4","5","12","4","5","5","14","4","16","18",0,0.00303496238433596,0,"0"
"371830535211016","1","5","1","7","1","5","1","7","2","9","9",0,0.00733831146574699,0,"0"
"371830525061018","4","3","3","10","4","3","3","10","4","14","14",45,0.0198569739904933,2266.20632235023,"16"
"371830524011084","3","5","4","12","3","5","4","12","3","15","15",25,0.0110516551186311,2262.10461072519,"12"
"371830538082007","1","3","3","7","4","3","3","10","5","12","15",70,0.0243414899532119,2875.74836768623,"21"
"371830503001005","5","5","5","15","5","5","5","15","3","18","18",0,0.000782085951777273,0,"0"
"371830524082000","5","5","4","14","5","5","5","15","4","18","19",184,0.016120742957119,11413.8660041562,"69"
"371830523021007","3","5","5","13","3","5","5","13","5","18","18",80,0.0555795109995276,1439.3793425185,"73"
"371830523021005","4","5","5","14","4","5","5","14","5","19","19",2,0.00419942705807979,476.25544445449,"1"
"371830521021041","2","2","3","7","2","3","4","9","4","11","13",0,0.0252533886052996,0,"0"
"371830521013002","2","3","4","9","2","3","4","9","3","12","12",76,0.00395667064306623,19208.0683119744,"17"
"371830528063006","5","2","2","9","5","3","3","11","4","13","15",0,0.000441265104723725,0,"0"
"371830527012035","2","2","4","8","2","3","4","9","3","11","12",56,0.0108688297340422,5152.34863092968,"23"
"371830527052001","4","3","4","11","4","4","5","13","2","13","15",113,0.0216335157722941,5223.3765971927,"45"
"371830528064027","3","1","1","5","3","2","2","7","3","8","10",35,0.00453148111519764,7723.74398353274,"11"
"371830528064032","1","1","1","3","1","2","1","4","3","6","7",5,0.00958932228480906,521.413281512162,"3"
"371830528064026","3","1","1","5","3","4","2","9","3","8","12",116,0.0119857186396589,9678.18480371916,"34"
"371830528064046","1","1","1","3","1","2","1","4","4","7","8",18,0.00365037194370524,4931.00436820952,"10"
"371830521013006","2","3","4","9","2","3","4","9","3","12","12",63,0.00577812505901272,10903.1908026519,"14"
"371830545003004","1","2","3","6","1","2","3","6","3","9","9",42,0.00752460224746281,5581.69038292513,"18"
"371830545004017","2","4","3","9","2","4","3","9","3","12","12",2,0.00153149540989978,1305.91315329563,"1"
"371830535211020","2","5","2","9","2","5","2","9","3","12","12",0,0.0125485013552522,0,"0"
"371830535161004","1","2","1","4","1","2","1","4","2","6","6",0,0.000956518666405137,0,"0"
"371830512003015","5","5","5","15","5","5","5","15","4","19","19",24,0.00653767321035966,3671.03084350704,"9"
"371830525051023","4","3","4","11","4","4","5","13","5","16","18",14,0.00759206480105451,1844.030624983,"9"
"371830525061001","3","3","3","9","3","3","3","9","4","13","13",76,0.0484080694274406,1569.98617996773,"30"
"371830524011029","1","5","3","9","1","5","3","9","5","14","14",0,0.00729101470640619,0,"0"
"371830524011087","1","5","3","9","1","5","3","9","5","14","14",0,0.00536129529941335,0,"0"
"371830516001013","3","4","5","12","5","4","5","14","3","15","17",52,0.0120812068961551,4304.20573432522,"19"
"371830536101038","2","1","1","4","2","1","1","4","1","5","5",18,0.00295398474609949,6093.46409921974,"18"
"371830516003000","3","4","4","11","4","4","5","13","3","14","16",9,0.00233910363320342,3847.6277289495,"5"
"371830540141084","1","2","2","5","2","3","2","7","4","9","11",27,0.0441801190290781,611.134614241971,"7"
"371830527012007","2","3","4","9","2","3","4","9","2","11","11",67,0.00439491609818402,15244.8871612553,"41"
"371830540171051","2","4","3","9","2","4","3","9","3","12","12",10,0.00627499170469594,1593.6276047212,"4"
"371830514001004","5","5","5","15","5","5","5","15","4","19","19",16,0.00609545864362331,2624.90502117313,"7"
"371830514005008","5","5","5","15","5","5","5","15","3","18","18",53,0.0137835307483032,3845.16862680663,"24"
"371830517003016","3","3","4","10","5","3","5","13","5","15","18",91,0.0212158219428347,4289.25168420042,"27"
"371830506002008","5","4","5","14","5","5","5","15","4","18","19",58,0.00571129949683994,10155.3070421349,"23"
"371830507002005","5","5","5","15","5","5","5","15","5","20","20",37,0.0083012428317009,4457.16391510725,"17"
"371830507003024","5","5","5","15","5","5","5","15","4","19","19",30,0.00383261132609746,7827.56127544699,"14"
"371830508001007","5","5","5","15","5","5","5","15","5","20","20",0,0.000217405776539012,0,"0"
"371830528033010","1","2","3","6","4","3","4","11","3","9","14",88,0.00870827909502288,10105.326097127,"27"
"371830528064005","1","1","1","3","1","1","1","3","4","7","7",30,0.00312020610277119,9614.74947868209,"11"
"371830525043032","5","5","4","14","5","5","4","14","4","18","18",65,0.00952099641402977,6827.01654043463,"40"
"371830525032004","2","1","2","5","2","1","3","6","4","9","10",129,0.00371402875799968,34733.1720903199,"73"
"371830537251002","5","5","3","13","5","5","3","13","4","17","17",0,6.10442126459967e-05,0,"0"
"371830519001001","2","3","4","9","4","3","5","12","5","14","17",0,0.0147261730646081,0,"0"
"371830521021037","4","4","4","12","4","4","5","13","3","15","16",32,0.0144411076020978,2215.8965144302,"14"
"371830521014030","5","5","5","15","5","5","5","15","4","19","19",72,0.0123753987907027,5817.99433033959,"31"
"371830527072027","3","3","4","10","3","3","4","10","3","13","13",53,0.0131036396318201,4044.67777573018,"14"
"371830541052000","2","2","2","6","2","2","2","6","4","10","10",0,0.000644343706020126,0,"0"
"371830541055007","2","3","2","7","2","3","3","8","3","10","11",41,0.06392451698081,641.381459515887,"17"
"371830541054005","2","3","2","7","2","3","3","8","3","10","11",8,0.00630117482816201,1269.60451315291,"3"
"371830535211014","2","5","1","8","2","5","1","8","3","11","11",0,0.010479932237009,0,"0"
"371830537171011","2","5","1","8","2","5","1","8","2","10","10",53,0.00852149301130049,6219.56738446136,"22"
"371830537142016","5","3","3","11","5","3","3","11","5","16","16",0,5.25116120419232e-05,0,"0"
"371830537132014","4","2","2","8","4","2","3","9","4","12","13",63,0.044941346816268,1401.82714722726,"21"
"371830537191007","1","1","1","3","3","1","1","5","1","4","6",62,0.0115200370313318,5381.92714410332,"19"
"371830540151012","3","3","3","9","3","3","3","9","2","11","11",0,0.0335240750452873,0,"0"
"371830540043005","3","4","4","11","3","4","4","11","2","13","13",68,0.00532161299491616,12778.0806430234,"37"
"371830527043015","5","3","4","12","5","4","4","13","2","14","15",20,0.00391375669879795,5110.17969158448,"7"
"371830540111002","2","4","3","9","2","5","3","10","3","12","13",28,0.0084524408514811,3312.65258071503,"10"
"371830519002013","4","4","5","13","5","4","5","14","4","17","18",43,0.00785367504300907,5475.14377212186,"16"
"371830527063025","1","1","2","4","1","1","3","5","3","7","8",0,0.00429933685262665,0,"0"
"371830519003006","5","2","4","11","5","3","5","13","5","16","18",61,0.00960274227844341,6352.3520918535,"20"
"371830501001090","5","5","5","15","5","5","5","15","5","20","20",356,0.00506905313984646,70230.0785133973,"243"
"371830515011019","3","3","4","10","4","3","5","12","4","14","16",0,0.000859191557426964,0,"0"
"371830515012006","4","3","4","11","4","3","5","12","4","15","16",34,0.0116782305773445,2911.39995693861,"13"
"371830540171061","2","4","3","9","2","4","3","9","2","11","11",0,0.000379328504618975,0,"0"
"371830515012037","4","4","4","12","4","4","5","13","3","15","16",39,0.0139200749192787,2801.7090587628,"15"
"371830537251015","4","5","2","11","4","5","2","11","4","15","15",0,0.000392464878885213,0,"0"
"371830545002000","3","5","5","13","3","5","5","13","4","17","17",0,0.0013768638747607,0,"0"
"371830537241059","2","5","2","9","2","5","2","9","2","11","11",0,0.00123384333722786,0,"0"
"371830537171017","1","1","1","3","5","1","2","8","1","4","9",5,0.0301732576687795,165.709651072033,"1"
"371830537252029","1","5","2","8","1","5","2","8","3","11","11",51,0.00253668827087404,20104.9536064703,"26"
"371830537111020","3","5","2","10","3","5","2","10","2","12","12",0,0.000354869513165123,0,"0"
"371830537181024","1","1","1","3","2","1","1","4","1","4","5",54,0.00494485016122107,10920.4522360421,"21"
"371830537241044","3","5","2","10","3","5","2","10","2","12","12",63,0.00343409632804605,18345.4376295397,"28"
"371830537171029","1","5","1","7","2","5","1","8","1","8","9",154,0.00724110646989968,21267.4679816072,"88"
"371830540143033","1","2","2","5","1","3","2","6","2","7","8",217,0.0211007531555912,10283.9931067816,"71"
"371830540171020","2","4","3","9","2","4","3","9","2","11","11",91,0.00338051787159901,26918.9524967535,"40"
"371830540142007","4","2","1","7","4","3","2","9","3","10","12",19,0.00829535657865273,2290.4380082822,"6"
"371830540043008","3","3","3","9","3","4","4","11","2","11","13",0,0.000935924098341085,0,"0"
"371830541063023","5","3","2","10","5","4","3","12","5","15","17",33,0.0022766540236231,14494.9560440823,"12"
"371830545001047","3","5","4","12","3","5","5","13","5","17","18",0,0.00345693741533536,0,"0"
"371830527062014","1","3","4","8","1","3","4","8","3","11","11",0,0.00587852732062815,0,"0"
"371830519001041","4","4","5","13","5","4","5","14","3","16","17",52,0.0284357397574831,1828.68462165876,"22"
"371830526011005","3","3","3","9","4","3","4","11","5","14","16",31,0.00792147632797164,3913.41193440615,"12"
"371830537143004","2","2","3","7","2","2","3","7","3","10","10",0,0.00414390109098028,0,"0"
"371830526011022","4","4","4","12","4","4","4","12","4","16","16",41,0.0105836851073481,3873.88698587926,"15"
"371830528072038","1","1","2","4","1","2","2","5","3","7","8",0,0.0036529147417343,0,"0"
"371830527063016","2","3","3","8","2","3","4","9","3","11","12",22,0.00784658658469311,2803.76693260697,"7"
"371830537252040","1","5","2","8","1","5","2","8","3","11","11",0,0.000116195547703972,0,"0"
"371830537113004","4","5","2","11","4","5","2","11","5","16","16",0,0.00306746628018926,0,"0"
"371830537241008","3","5","2","10","3","5","2","10","2","12","12",0,0.00130008940771597,0,"0"
"371830537241063","2","5","2","9","2","5","2","9","2","11","11",0,0.00300594376094139,0,"0"
"371830537111031","4","1","2","7","4","1","2","7","4","11","11",17,0.00394626360231109,4307.87238593086,"5"
"371830540081013","3","3","3","9","4","4","3","11","2","11","13",82,0.0207947399898253,3943.30489537845,"31"
"371830540171029","2","4","3","9","2","4","3","9","2","11","11",0,0.0544806462244055,0,"0"
"371830518001026","3","4","5","12","5","4","5","14","4","16","18",41,0.00870842468588847,4708.08458232845,"22"
"371830504001000","3","4","5","12","4","4","5","13","4","16","17",0,0.00450839293934952,0,"0"
"371830505003008","3","4","5","12","4","5","5","14","4","16","18",0,0.00811832870223378,0,"0"
"371830545002045","1","2","3","6","1","2","3","6","2","8","8",0,0.0194955426762505,0,"0"
"371830541103041","1","1","1","3","5","2","2","9","3","6","12",0,0.0228258555647281,0,"0"
"371830524011038","1","5","2","8","1","5","2","8","2","10","10",0,0.0106924389976108,0,"0"
"371830537261004","4","5","3","12","4","5","3","12","4","16","16",4,0.00393413754363361,1016.74126937249,"2"
"371830537072006","3","3","3","9","3","3","4","10","5","14","15",34,0.00724514821632484,4692.79564542115,"18"
"371830537163004","4","4","4","12","4","4","4","12","4","16","16",120,0.0295750769330426,4057.47042591563,"52"
"371830537122005","2","2","2","6","2","2","2","6","3","9","9",10,0.00547117548985819,1827.76078349832,"5"
"371830537131007","2","2","2","6","2","2","3","7","4","10","11",38,0.00346986115023567,10951.4468604656,"33"
"371830537211047","5","5","2","12","5","5","2","12","2","14","14",1,0.00280519945730816,356.480890296332,"1"
"371830537121013","4","3","3","10","4","3","3","10","5","15","15",2,0.000759940288766732,2631.78571996189,"1"
"371830537111019","3","5","2","10","3","5","2","10","2","12","12",0,2.50820800582043e-05,0,"0"
"371830540131022","2","5","2","9","2","5","2","9","5","14","14",48,0.00681777595351234,7040.41909374737,"14"
"371830540134044","2","5","2","9","2","5","2","9","5","14","14",52,0.00569986461506478,9123.02370525848,"14"
"371830540171009","1","4","2","7","1","4","3","8","3","10","11",95,0.0139280921157117,6820.74753747747,"43"
"371830518002006","5","4","5","14","5","4","5","14","5","19","19",47,0.0132449906060688,3548.51138803109,"24"
"371830524011074","3","5","3","11","3","5","4","12","3","14","15",0,0.00960395601356618,0,"0"
"371830520021016","4","4","4","12","5","5","5","15","5","17","20",82,0.0191920367107502,4272.60541629063,"33"
"371830537162013","4","4","3","11","4","4","4","12","4","15","16",14,0.00374965134090232,3733.68047511079,"6"
"371830537112023","5","3","3","11","5","3","3","11","5","16","16",4,0.0057361801936052,697.328163515378,"1"
"371830526023002","4","3","4","11","4","3","4","11","3","14","14",52,0.0126653470129074,4105.69090187631,"24"
"371830517001021","5","4","5","14","5","5","5","15","4","18","19",3,0.000456629922169386,6569.871693356,"1"
"371830526032017","4","3","4","11","4","3","5","12","5","16","17",18,0.00423837361969229,4246.91205050177,"7"
"371830526032003","3","3","4","10","4","4","5","13","4","14","17",0,0.0128135917556788,0,"0"
"371830518002002","5","4","5","14","5","4","5","14","5","19","19",124,0.0246059092143332,5039.43987275093,"45"
"371830527073028","3","4","3","10","3","4","4","11","2","12","13",0,0.000617445622190486,0,"0"
"371830527073032","2","3","3","8","2","3","3","8","2","10","10",58,0.0225135856130662,2576.22224184221,"25"
"371830541061049","3","3","2","8","3","3","2","8","3","11","11",25,0.00464825211449504,5378.36575646153,"5"
"371830525071001","3","2","2","7","3","2","3","8","4","11","12",0,0.00255964054994678,0,"0"
"371830525071000","2","2","2","6","2","2","2","6","4","10","10",0,0.000370485723911107,0,"0"
"371830537071010","2","2","2","6","2","2","3","7","3","9","10",14,0.00541208924057733,2586.80139548227,"6"
"371830528033066","1","1","2","4","1","1","2","4","2","6","6",0,0.0151539528185703,0,"0"
"371830520024007","4","4","5","13","4","5","5","14","3","16","17",18,0.00225301877900438,7989.28094507683,"4"
"371830541043038","1","3","3","7","5","4","3","12","2","9","14",81,0.00627905057381376,12900.0394323632,"25"
"371830541062001","2","3","3","8","2","3","4","9","3","11","12",0,0.000736732663558335,0,"0"
"371830527051029","2","3","4","9","2","3","4","9","3","12","12",48,0.0537739923824101,892.624814959828,"16"
"371830528062033","2","2","2","6","4","3","3","10","5","11","15",26,0.00261089074595758,9958.28723980718,"9"
"371830541051022","3","2","2","7","3","2","2","7","4","11","11",40,0.0035113012483659,11391.788163609,"11"
"371830541051016","4","2","2","8","4","2","2","8","4","12","12",49,0.00475275819330932,10309.8028569978,"13"
"371830540171014","1","4","3","8","1","4","3","8","3","11","11",36,0.00796007889832058,4522.56823831172,"14"
"371830541042002","5","5","3","13","5","5","3","13","5","18","18",4,0.00401219839319429,996.959673476023,"1"
"371830540141036","2","2","1","5","3","4","2","9","4","9","13",35,0.00248778211552195,14068.7561750788,"13"
"371830540111007","1","3","3","7","1","3","3","7","3","10","10",86,0.0275642246934301,3119.98617615746,"31"
"371830519001010","4","4","5","13","5","4","5","14","3","16","17",47,0.015576279365537,3017.40864406868,"23"
"371830519003010","3","2","4","9","3","2","5","10","4","13","14",101,0.0179493638976407,5626.9403515339,"39"
"371830519003008","5","2","4","11","5","2","5","12","5","16","17",54,0.0123899884614099,4358.35756975798,"22"
"371830519002014","5","4","5","14","5","4","5","14","5","19","19",41,0.00851144427361999,4817.04381559234,"17"
"371830501001003","5","5","5","15","5","5","5","15","4","19","19",179,0.0111017097580737,16123.6425650402,"72"
"371830501001068","5","5","5","15","5","5","5","15","5","20","20",13,0.00509488706564776,2551.5776566771,"9"
"371830501001054","5","5","5","15","5","5","5","15","5","20","20",49,0.00516541350845774,9486.17180788497,"35"
"371830515012000","3","4","4","11","3","4","5","12","3","14","15",0,0.00133038905897072,0,"0"
"371830545002007","5","4","4","13","5","4","5","14","4","17","18",62,0.0131119218516271,4728.52116582027,"31"
"371830521014026","4","5","5","14","4","5","5","14","5","19","19",33,0.0086906486005521,3797.18494174343,"15"
"371830545002052","2","2","3","7","2","2","3","7","3","10","10",0,0.0065158499097449,0,"0"
"371830541063036","3","3","2","8","3","3","2","8","4","12","12",260,0.0383849491173827,6773.48820249597,"85"
"371830542091068","3","1","1","5","3","1","1","5","3","8","8",53,0.00539939061620586,9815.92253039158,"17"
"371830537112024","4","5","3","12","4","5","3","12","5","17","17",17,0.00675964170026398,2514.92619783917,"5"
"371830537261006","5","5","3","13","5","5","3","13","5","18","18",38,0.00483302216249124,7862.57515947587,"27"
"371830541102029","1","1","1","3","1","2","1","4","3","6","7",21,0.001679171010841,12506.1711192134,"5"
"371830542091048","2","1","1","4","2","1","1","4","3","7","7",0,0.00239081150431312,0,"0"
"371830541102020","1","1","1","3","1","2","1","4","3","6","7",143,0.0174133112201317,8212.10843774942,"55"
"371830540123003","2","3","3","8","2","3","3","8","2","10","10",90,0.0726460864989338,1238.88297824992,"41"
"371830523022012","2","5","3","10","3","5","3","11","3","13","14",52,0.0036458899854719,14262.6355175853,"13"
"371830537251026","3","5","2","10","3","5","2","10","4","14","14",87,0.00639142915152897,13611.9790953464,"46"
"371830523021046","3","5","4","12","3","5","4","12","4","16","16",0,0.0214584651215877,0,"0"
"371830523011020","4","5","3","12","4","5","3","12","4","16","16",8,0.00118173850603371,6769.68716780715,"5"
"371830537241000","2","5","1","8","2","5","1","8","2","10","10",178,0.0291040178823721,6115.99404313905,"59"
"371830537113021","5","5","3","13","5","5","3","13","4","17","17",0,0.000739731386164848,0,"0"
"371830524011044","1","5","2","8","1","5","3","9","5","13","14",21,0.00193707476573696,10841.0890335513,"11"
"371830525031009","2","5","2","9","2","5","2","9","3","12","12",0,0.000657646980442151,0,"0"
"371830540171055","3","5","3","11","3","5","3","11","2","13","13",0,0.000117366211972498,0,"0"
"371830540134001","1","5","2","8","1","5","2","8","5","13","13",46,0.00668228990042014,6883.8677587316,"27"
"371830507003023","5","5","5","15","5","5","5","15","4","19","19",0,0.00683904445659407,0,"0"
"371830545001049","4","4","4","12","4","4","5","13","4","16","17",0,0.00779986976320034,0,"0"
"371830521014019","4","5","5","14","4","5","5","14","5","19","19",30,0.00702182948824619,4272.3908420472,"16"
"371830528033073","2","2","4","8","2","3","4","9","3","11","12",70,0.00720744315629181,9712.18204321081,"21"
"371830541062052","4","2","2","8","4","3","2","9","5","13","14",9,0.00706849386622396,1273.25568506263,"6"
"371830541063028","3","3","2","8","3","3","3","9","3","11","12",0,0.00655880773903859,0,"0"
"371830541102043","3","2","1","6","3","3","2","8","4","10","12",0,0.000672959963344942,0,"0"
"371830527073025","3","3","3","9","3","3","4","10","2","11","12",69,0.00534384987426158,12912.0393767676,"18"
"371830541053012","4","2","1","7","4","2","2","8","5","12","13",233,0.0317176395392465,7346.06999085453,"135"
"371830542071040","2","4","1","7","2","4","1","7","2","9","9",74,0.0261202934296643,2833.04627489214,"21"
"371830542071097","2","4","1","7","2","5","1","8","3","10","11",17,0.00277935525822598,6116.52646767108,"6"
"371830537262014","2","5","2","9","2","5","2","9","4","13","13",2,0.00529732496013554,377.54904882196,"1"
"371830537191008","1","1","1","3","4","1","1","6","1","4","7",63,0.135611887121524,464.561045032466,"27"
"371830523023008","2","5","3","10","2","5","3","10","3","13","13",0,0.000256304287611261,0,"0"
"371830537111023","2","5","2","9","2","5","2","9","2","11","11",152,0.0457778291471464,3320.3846235569,"70"
"371830524011036","1","5","2","8","1","5","2","8","3","11","11",20,0.0709243314649959,281.990673537343,"11"
"371830524011069","2","5","3","10","3","5","4","12","3","13","15",28,0.00812404554032261,3446.55872016297,"17"
"371830525033011","2","5","3","10","2","5","3","10","5","15","15",0,0.00320777561642561,0,"0"
"371830527013008","1","1","2","4","1","1","3","5","2","6","7",0,0.00355291258269073,0,"0"
"371830525052008","3","3","3","9","3","3","4","10","4","13","14",18,0.00275490835578264,6533.79266218327,"10"
"371830525052005","1","3","3","7","1","3","3","7","3","10","10",0,0.000248219078381015,0,"0"
"371830537143005","2","2","3","7","2","2","3","7","3","10","10",0,0.00271097378011539,0,"0"
"371830537232002","3","1","3","7","3","1","3","7","3","10","10",18,0.00307707044840308,5849.71982339291,"11"
"371830525042002","5","5","4","14","5","5","5","15","5","19","20",64,0.00733634403823238,8723.69121001858,"43"
"371830525033021","2","5","2","9","2","5","3","10","4","13","14",1,0.00430509391764797,232.282969693339,"1"
"371830525031004","1","5","2","8","1","5","2","8","3","11","11",20,0.00296943914704972,6735.27861982656,"16"
"371830525041006","2","5","3","10","2","5","4","11","4","14","15",20,0.0362750910483494,551.342516917267,"6"
"371830524011089","1","5","3","9","1","5","3","9","5","14","14",0,0.00615906582687197,0,"0"
"371830525033030","3","5","3","11","3","5","4","12","4","15","16",0,0.010362183509391,0,"0"
"371830523013014","3","5","3","11","3","5","4","12","4","15","16",27,0.000913034210713458,29571.7287295312,"10"
"371830523013017","2","5","3","10","2","5","3","10","3","13","13",0,0.00707346407991099,0,"0"
"371830542071035","1","4","1","6","1","4","1","6","2","8","8",41,0.00758883337172526,5402.67495564723,"11"
"371830538082023","2","2","3","7","3","2","3","8","4","11","12",67,0.0379029198672563,1767.67384240179,"23"
"371830535211013","1","5","1","7","1","5","1","7","2","9","9",0,0.00777126071273899,0,"0"
"371830537142031","3","3","3","9","3","3","3","9","4","13","13",91,0.00637144117385813,14282.4829605853,"54"
"371830525051018","4","3","4","11","4","3","4","11","5","16","16",0,0.000104921968513962,0,"0"
"371830524072001","3","5","4","12","4","5","4","13","3","15","16",65,0.0117119018464905,5549.90989951624,"26"
"371830537121001","2","1","2","5","2","1","2","5","3","8","8",84,0.0351015965535665,2393.05354307211,"34"
"371830525043037","4","5","3","12","4","5","4","13","3","15","16",15,0.00115511243214024,12985.7489042927,"7"
"371830524011092","1","5","3","9","1","5","4","10","5","14","15",0,0.0112590768823742,0,"0"
"371830512002002","5","5","5","15","5","5","5","15","3","18","18",0,0.00596394160633257,0,"0"
"371830508003004","5","5","5","15","5","5","5","15","4","19","19",88,0.0069379340769958,12683.8910579711,"26"
"371830516005004","3","4","5","12","5","4","5","14","3","15","17",51,0.0104555445544154,4877.79471787174,"21"
"371830516005014","4","4","5","13","5","5","5","15","3","16","18",0,0.000520809113386034,0,"0"
"371830541062041","3","2","2","7","3","2","2","7","4","11","11",87,0.0558695261535713,1557.19953236866,"35"
"371830541062006","3","2","2","7","3","3","3","9","3","10","12",0,0.000263594216091925,0,"0"
"371830530081037","2","4","2","8","2","4","2","8","3","11","11",8,0.005449268059554,1468.0870738179,"4"
"371830530082001","2","3","2","7","2","3","2","7","2","9","9",10,0.00749407272927979,1334.3879037802,"2"
"371830523022016","4","5","4","13","5","5","4","14","3","16","17",72,0.0108208737625334,6653.80648365899,"31"
"371830536102069","4","5","1","10","4","5","2","11","1","11","12",0,0.00607449444890721,0,"0"
"371830523023004","3","5","3","11","4","5","3","12","3","14","15",57,0.00656351721912191,8684.36816680213,"19"
"371830523023021","2","3","2","7","2","3","2","7","2","9","9",186,0.00311186915277351,59771.1506713655,"54"
"371830530091004","1","2","3","6","1","2","3","6","2","8","8",0,0.00633864256889143,0,"0"
"371830523013020","2","5","3","10","2","5","3","10","3","13","13",0,0.00602995669959059,0,"0"
"371830530082006","2","5","3","10","2","5","3","10","3","13","13",307,0.0727467503372685,4220.11977960097,"147"
"371830537092010","1","5","2","8","1","5","2","8","3","11","11",41,0.00377668471708128,10856.0822709304,"30"
"371830537141004","3","2","3","8","3","2","3","8","4","12","12",65,0.0141745440989179,4585.6854052161,"28"
"371830537241007","4","5","2","11","4","5","2","11","2","13","13",0,0.00262978421919696,0,"0"
"371830537093003","3","5","2","10","3","5","2","10","2","12","12",0,0.0413958952160795,0,"0"
"371830537262016","3","5","3","11","3","5","3","11","4","15","15",28,0.00585296492909678,4783.90018378615,"24"
"371830537241043","3","5","2","10","3","5","2","10","2","12","12",48,0.00244656410569855,19619.3510270989,"22"
"371830527051008","5","3","4","12","5","3","4","12","2","14","14",83,0.0206696627389605,4015.54689344556,"35"
"371830537113009","4","5","2","11","4","5","2","11","4","15","15",19,0.00236573628342703,8031.32628649394,"11"
"371830537252048","1","5","2","8","1","5","2","8","3","11","11",53,0.00168976333420822,31365.3391140922,"30"
"371830527013005","4","3","4","11","4","4","5","13","3","14","16",330,0.0161260799032847,20463.7458067402,"172"
"371830540081012","4","4","3","11","4","4","3","11","2","13","13",5,0.00208999192016964,2392.35374632174,"2"
"371830540081014","5","4","3","12","5","4","3","12","2","14","14",28,0.00345190010196272,8111.4746003453,"11"
"371830540141057","2","2","1","5","3","4","2","9","4","9","13",28,0.00192428420454364,14550.8651652839,"13"
"371830521014021","4","5","5","14","4","5","5","14","5","19","19",19,0.0109012503899506,1742.91932763192,"11"
"371830504002005","5","5","5","15","5","5","5","15","3","18","18",6,0.0133894050844029,448.115503428103,"4"
"371830511012004","4","4","5","13","4","5","5","14","5","18","19",77,0.0299833506112096,2568.09190535273,"28"
"371830509002009","5","5","5","15","5","5","5","15","5","20","20",0,0.035310431339767,0,"0"
"371830524041030","5","5","4","14","5","5","4","14","5","19","19",0,0.000257113450218194,0,"0"
"371830505002006","4","4","5","13","4","5","5","14","3","16","17",0,0.00958847319121691,0,"0"
"371830541054007","5","5","3","13","5","5","4","14","2","15","16",53,0.00910997952797749,5817.79573019157,"32"
"371830541051008","4","2","2","8","4","2","2","8","4","12","12",19,0.00663278291961295,2864.55930041334,"8"
"371830509002019","5","5","5","15","5","5","5","15","5","20","20",49,0.0026189597013268,18709.7189678696,"13"
"371830540141061","3","3","1","7","3","4","2","9","4","11","13",0,0.000628827912498823,0,"0"
"371830540141058","3","4","2","9","3","5","2","10","4","13","14",13,0.00488112224379952,2663.32194742999,"8"
"371830516002019","5","4","4","13","5","4","5","14","3","16","17",15,0.00616751509904055,2432.09781559083,"7"
"371830516002017","5","4","4","13","5","4","5","14","3","16","17",40,0.0121811452347342,3283.7634909681,"16"
"371830505003009","3","4","5","12","4","4","5","13","3","15","16",0,0.0188416339122835,0,"0"
"371830501001008","4","5","5","14","5","5","5","15","3","17","18",3,0.00822102410816714,364.918039471465,"0"
"371830518003002","5","4","5","14","5","4","5","14","5","19","19",159,0.0411716974540486,3861.87623615613,"52"
"371830540011007","4","3","4","11","4","3","4","11","4","15","15",75,0.0173253630655029,4328.91361159033,"42"
"371830506002005","5","4","5","14","5","5","5","15","3","17","18",19,0.00448230908099856,4238.88662219769,"10"
"371830537262017","3","5","2","10","3","5","2","10","4","14","14",128,0.0176919792375487,7234.91692372881,"81"
"371830537132013","3","2","3","8","3","2","3","8","4","12","12",150,0.00515168272419239,29116.6999271127,"66"
"371830525043027","3","5","3","11","3","5","4","12","3","14","15",41,0.00156599505749545,26181.4363996606,"31"
"371830525033018","3","5","3","11","3","5","3","11","4","15","15",57,0.00920204389009172,6194.2760413667,"50"
"371830540132010","1","4","1","6","1","5","2","8","5","11","13",0,0.000616141939528139,0,"0"
"371830540181006","4","4","4","12","4","4","4","12","2","14","14",4,0.00425970806185282,939.03148805464,"2"
"371830514004013","5","5","5","15","5","5","5","15","5","20","20",18,0.0101433427111615,1774.56293379432,"17"
"371830514005014","5","5","5","15","5","5","5","15","3","18","18",56,0.0142870116589411,3919.64403311411,"26"
"371830520011013","3","2","3","8","5","3","5","13","3","11","16",63,0.00194706227577971,32356.438098402,"39"
"371830520023004","4","3","4","11","5","4","5","14","5","16","19",15,0.00350315600087613,4281.8532763738,"5"
"371830519003009","3","2","4","9","3","2","5","10","4","13","14",51,0.0113476503913634,4494.32245804961,"20"
"371830524061002","3","5","3","11","3","5","4","12","3","14","15",42,0.00867330131054127,4842.44677963101,"13"
"371830524072021","3","5","3","11","3","5","3","11","3","14","14",0,0.0052763188918319,0,"0"
"371830528033053","2","1","2","5","2","2","3","7","3","8","10",0,0.00156357741918887,0,"0"
"371830528033013","2","2","3","7","3","3","4","10","3","10","13",31,0.0161379007403974,1920.94377693121,"11"
"371830523013031","2","5","3","10","2","5","3","10","3","13","13",7,0.0114853943848054,609.469711310969,"3"
"371830530081047","2","4","2","8","2","4","2","8","3","11","11",33,0.00889749143846167,3708.9105652127,"13"
"371830523011017","4","5","3","12","4","5","3","12","4","16","16",35,0.0024639026079985,14205.1069252414,"23"
"371830536101047","1","5","1","7","1","5","1","7","1","8","8",0,0.000625052560927853,0,"0"
"371830536101068","4","1","1","6","4","1","1","6","1","7","7",29,0.00190039297678539,15260.001670315,"16"
"371830540011006","4","3","4","11","4","3","4","11","3","14","14",26,0.00875322976957834,2970.3321727441,"14"
"371830537093004","3","5","2","10","3","5","2","10","2","12","12",30,0.00458589857526787,6541.79317479729,"20"
"371830518003001","5","4","5","14","5","4","5","14","5","19","19",37,0.0527070365651792,701.993555533039,"14"
"371830541042017","3","2","2","7","3","2","2","7","3","10","10",62,0.00986217911404639,6286.64307178272,"15"
"371830541051014","4","3","2","9","4","3","2","9","4","13","13",41,0.00372766140260967,10998.8530533639,"10"
"371830537222002","2","2","3","7","2","2","3","7","3","10","10",76,0.0264490387711085,2873.45036081305,"29"
"371830525051009","3","3","3","9","3","3","3","9","4","13","13",37,0.0124616784196387,2969.10245586909,"14"
"371830540013005","4","3","4","11","4","3","4","11","3","14","14",0,0.00953632096419741,0,"0"
"371830537092020","2","5","2","9","2","5","2","9","3","12","12",79,0.0054331891091304,14540.2632621864,"47"
"371830501001045","5","5","5","15","5","5","5","15","5","20","20",52,0.00461030892940794,11279.070621126,"23"
"371830537093054","1","5","2","8","1","5","2","8","3","11","11",305,0.028244474063921,10798.5724680072,"136"
"371830524062026","2","4","3","9","3","4","4","11","3","12","14",0,0.000224503638560219,0,"0"
"371830540171025","3","3","3","9","3","3","3","9","2","11","11",0,0.00382686496128471,0,"0"
"371830540134000","3","5","2","10","3","5","2","10","3","13","13",1717,1.26385020073586,1358.54708018427,"732"
"371830541041003","2","3","1","6","2","4","2","8","5","11","13",0,0.00189223766323488,0,"0"
"371830527012008","2","3","4","9","2","3","4","9","2","11","11",6,0.000378439770257507,15854.5704536216,"3"
"371830540133006","1","4","1","6","1","4","1","6","5","11","11",4,0.000400147652305767,9996.31005442824,"2"
"371830540143003","1","2","1","4","1","3","2","6","2","6","8",0,0.00219529594193317,0,"0"
"371830501001053","5","5","5","15","5","5","5","15","5","20","20",42,0.00820181090124998,5120.8203292762,"33"
"371830515022001","4","3","4","11","4","3","5","12","4","15","16",166,0.0527435064557348,3147.30686590426,"67"
"371830515022017","5","5","4","14","5","5","5","15","4","18","19",37,0.0114643856816203,3227.3861877587,"11"
"371830514004008","5","5","5","15","5","5","5","15","5","20","20",0,0.00703478348579816,0,"0"
"371830514003014","5","5","5","15","5","5","5","15","5","20","20",0,0.00192290334606503,0,"0"
"371830501001095","5","5","5","15","5","5","5","15","5","20","20",4,0.00107788490891452,3710.97133554658,"2"
"371830535211074","1","5","2","8","1","5","2","8","3","11","11",0,0.00439430992954387,0,"0"
"371830505002017","4","4","5","13","5","4","5","14","3","16","17",57,0.0122273066918712,4661.69708803443,"32"
"371830516002001","3","4","4","11","4","4","5","13","3","14","16",0,0.000230030088170294,0,"0"
"371830525061002","5","3","3","11","5","3","3","11","5","16","16",11,0.007608473729085,1445.75645414272,"5"
"371830510001012","5","5","5","15","5","5","5","15","5","20","20",135,0.0104624189083201,12903.3258162358,"100"
"371830524062005","1","5","2","8","3","5","3","11","3","11","14",0,0.00644164063381532,0,"0"
"371830524063014","1","2","2","5","3","2","2","7","2","7","9",76,0.00258572937691621,29392.0936500475,"36"
"371830541111012","1","1","1","3","5","2","2","9","1","4","10",0,0.0777969213516214,0,"0"
"371830530031005","1","3","2","6","3","4","2","9","3","9","12",0,0.00024547958603733,0,"0"
"371830505003023","4","4","5","13","5","5","5","15","3","16","18",0,0.00114758171952316,0,"0"
"371830537151005","5","5","4","14","5","5","4","14","5","19","19",74,0.021299197056742,3474.30937433278,"31"
"371830537072012","4","4","4","12","4","4","4","12","4","16","16",1,0.000458665569526795,2180.23777331204,"1"
"371830537163005","5","4","4","13","5","4","4","13","5","18","18",42,0.0119882950518211,3503.41727647253,"20"
"371830540012003","4","3","4","11","4","3","4","11","3","14","14",52,0.0122792242838877,4234.79519534733,"38"
"371830521021004","3","3","3","9","3","3","4","10","4","13","14",161,0.00199886093339663,80545.8735573042,"45"
"371830512003031","5","5","5","15","5","5","5","15","4","19","19",32,0.00665771167695283,4806.45626496191,"16"
"371830506003024","5","5","5","15","5","5","5","15","5","20","20",107,0.00732942320607805,14598.6931019713,"51"
"371830507001010","5","5","5","15","5","5","5","15","5","20","20",146,0.0171716973655376,8502.36274796061,"108"
"371830509002013","5","5","5","15","5","5","5","15","5","20","20",25,0.00679772236537808,3677.70242093574,"6"
"371830528072039","1","1","2","4","1","2","2","5","3","7","8",0,0.00209257352224478,0,"0"
"371830528061007","2","1","1","4","2","1","1","4","3","7","7",5,0.0113328069669822,441.196961579542,"1"
"371830542091075","3","2","1","6","3","3","2","8","4","10","12",77,0.0222367520300246,3462.7359200675,"30"
"371830536101008","1","5","1","7","1","5","1","7","1","8","8",162,0.0526103040147767,3079.24470374661,"93"
"371830537142002","2","3","3","8","2","3","3","8","4","12","12",53,0.0102391557169433,5176.20802585296,"15"
"371830537071012","3","2","3","8","3","2","3","8","3","11","11",15,0.00347360228138879,4318.28366775566,"9"
"371830540071014","2","1","2","5","3","1","3","7","5","10","12",18,0.00329398778266606,5464.50114196577,"8"
"371830540161001","3","5","3","11","3","5","3","11","4","15","15",12,0.00206865346722184,5800.87491217934,"8"
"371830512003006","5","5","5","15","5","5","5","15","4","19","19",53,0.00446275866763794,11876.0623074543,"31"
"371830516002000","3","4","4","11","3","4","5","12","3","14","15",0,0.00050641815966666,0,"0"
"371830506003012","5","4","5","14","5","5","5","15","4","18","19",50,0.00731234111542611,6837.7554070228,"19"
"371830507001014","5","5","5","15","5","5","5","15","5","20","20",18,0.0028088866992921,6408.23284347368,"11"
"371830506002037","5","4","5","14","5","5","5","15","4","18","19",0,0.00391803810858993,0,"0"
"371830508002004","5","5","5","15","5","5","5","15","5","20","20",44,0.00618257345436967,7116.77755626212,"18"
"371830517001013","5","4","5","14","5","4","5","14","4","18","18",54,0.00905891258816428,5960.98035768139,"19"
"371830537171003","2","5","1","8","2","5","2","9","2","10","11",5,0.0895279042912691,55.8485093511522,"2"
"371830537241041","3","5","2","10","3","5","2","10","2","12","12",84,0.0056621525563814,14835.3473636682,"40"
"371830537111005","5","5","2","12","5","5","2","12","2","14","14",24,0.00409220743778823,5864.80533180683,"5"
"371830537241070","2","5","1","8","2","5","1","8","2","10","10",107,0.00866036436719957,12355.1383594498,"36"
"371830537252033","1","5","2","8","1","5","2","8","3","11","11",0,0.000463758461351776,0,"0"
"371830540162011","3","5","3","11","3","5","3","11","2","13","13",0,0.0037114132746888,0,"0"
"371830540161004","3","5","3","11","3","5","3","11","4","15","15",14,0.00179173709334307,7813.64635024576,"7"
"371830541041027","3","3","2","8","3","4","3","10","3","11","13",0,0.00144929528645784,0,"0"
"371830540041007","5","5","4","14","5","5","4","14","2","16","16",26,0.00605903031417755,4291.11568218474,"17"
"371830503001012","5","5","5","15","5","5","5","15","3","18","18",4,0.00061428455430796,6511.64020314058,"2"
"371830524041009","4","5","4","13","4","5","4","13","4","17","17",78,0.0189555164237059,4114.89712316424,"27"
"371830524041024","4","5","4","13","4","5","4","13","4","17","17",10,0.00365596960233026,2735.25250145027,"4"
"371830537093057","1","5","1","7","1","5","1","7","2","9","9",8,0.00486644996048188,1643.90881750849,"4"
"371830509003006","5","5","5","15","5","5","5","15","5","20","20",59,0.00712313257699388,8282.8726493954,"20"
"371830524071002","3","5","4","12","3","5","4","12","3","15","15",0,0.0397647171034314,0,"0"
"371830545002049","2","2","3","7","2","2","3","7","3","10","10",0,0.0452992804711775,0,"0"
"371830519001018","3","3","4","10","4","4","5","13","3","13","16",24,0.00376054015116846,6382.06189409859,"11"
"371830520024006","4","4","5","13","4","5","5","14","3","16","17",38,0.00639106947659369,5945.79673076144,"14"
"371830526012016","2","3","4","9","2","3","4","9","3","12","12",0,0.00540968068968882,0,"0"
"371830516001008","3","4","5","12","5","4","5","14","4","16","18",0,0.000764536126213013,0,"0"
"371830528072000","2","2","2","6","3","3","3","9","4","10","13",0,0.000234985381517302,0,"0"
"371830521022001","4","4","4","12","4","4","5","13","3","15","16",49,0.00907680668808217,5398.37430539718,"16"
"371830528033072","1","1","2","4","1","1","2","4","2","6","6",0,0.00891306399768047,0,"0"
"371830528062048","3","2","3","8","3","2","3","8","3","11","11",18,0.0027431529394651,6561.79235982006,"7"
"371830528062016","3","2","3","8","3","2","3","8","3","11","11",59,0.00683056062402299,8637.65117499987,"17"
"371830537071013","4","2","3","9","4","2","3","9","4","13","13",0,0.00499026023966133,0,"0"
"371830501001051","5","5","5","15","5","5","5","15","5","20","20",0,0.0135158550270068,0,"0"
"371830537112011","4","5","2","11","4","5","2","11","3","14","14",3,0.00921169031927335,325.673127951684,"2"
"371830540143037","2","2","2","6","2","3","2","7","3","9","10",22,0.00270256951368824,8140.40115844283,"7"
"371830541041012","1","3","1","5","2","4","2","8","5","10","13",41,0.00961778632557345,4262.93521316668,"15"
"371830527011021","4","3","4","11","4","4","5","13","3","14","16",52,0.0027034682052281,19234.5520836678,"31"
"371830540043012","2","3","3","8","2","3","4","9","2","10","11",41,0.0032174543310435,12742.9936159196,"27"
"371830540171036","2","4","3","9","2","4","3","9","2","11","11",40,0.0023234667046037,17215.6544876431,"18"
"371830540143020","2","2","1","5","2","3","2","7","3","8","10",136,0.0453766994060047,2997.13292902046,"50"
"371830540081001","3","3","2","8","3","4","3","10","3","11","13",1,0.0215095030156543,46.4910788162895,"1"
"371830514003001","5","5","4","14","5","5","5","15","5","19","20",52,0.0121463959266903,4281.10530183987,"20"
"371830514003015","5","5","5","15","5","5","5","15","5","20","20",68,0.0115736444801537,5875.4180773917,"35"
"371830515022016","5","5","4","14","5","5","5","15","4","18","19",24,0.0107705966181956,2228.28881730238,"11"
"371830518003019","4","4","5","13","5","4","5","14","4","17","18",72,0.0153954583137312,4676.70390401974,"38"
"371830501001110","5","5","5","15","5","5","5","15","5","20","20",197,0.0153791310673587,12809.5663621803,"176"
"371830537091011","1","5","2","8","1","5","2","8","3","11","11",0,3.00237057647316e-05,0,"0"
"371830541043044","3","4","3","10","3","4","3","10","3","13","13",88,0.00584939892198393,15044.2808181995,"27"
"371830541063016","3","2","2","7","3","3","2","8","3","10","11",64,0.0026168475484909,24456.9080980311,"45"
"371830541063002","3","3","2","8","3","3","2","8","3","11","11",81,0.00406118499323761,19944.9175880625,"47"
"371830528062034","2","2","2","6","5","3","3","11","5","11","16",20,0.00203741534960884,9816.35875269115,"7"
"371830541051010","3","2","2","7","3","2","2","7","4","11","11",40,0.00552391512685648,7241.24087380085,"13"
"371839801001006","2","5","1","8","2","5","1","8","1","9","9",0,0.000540987014149798,0,"0"
"371830537121014","4","3","3","10","4","3","3","10","5","15","15",3,0.00272493236658156,1100.94475620454,"1"
"371830527063007","2","3","3","8","2","3","4","9","3","11","12",13,0.00418703736722907,3104.82063087086,"4"
"371830536101003","1","5","1","7","1","5","1","7","1","8","8",0,0.00548604938296172,0,"0"
"371830540131027","2","5","2","9","2","5","2","9","4","13","13",80,0.0181334567717976,4411.73467402098,"25"
"371830527011005","5","3","4","12","5","3","4","12","2","14","14",21,0.00651649391212137,3222.59182363967,"10"
"371830537232001","3","1","3","7","3","1","3","7","3","10","10",5,0.0170352098925779,293.509738449331,"1"
"371830537071006","3","2","3","8","3","2","3","8","3","11","11",2,0.000572902387765642,3490.99609760772,"1"
"371830525051020","4","3","4","11","4","3","4","11","5","16","16",2,0.00229276552844677,872.308997664883,"1"
"371830537171037","1","5","1","7","1","5","1","7","1","8","8",0,0.0043621476614088,0,"0"
"371830524062027","1","4","3","8","2","4","3","9","3","11","12",2,0.0139163810288035,143.715524593678,"2"
"371830525031006","1","5","2","8","1","5","2","8","4","12","12",6,0.0108910695156186,550.910082007609,"4"
"371830525041016","1","5","3","9","1","5","3","9","4","13","13",0,0.00818515699665919,0,"0"
"371830525041004","1","3","3","7","1","3","4","8","3","10","11",6,0.00323018590148017,1857.47823283193,"2"
"371830525041010","2","5","3","10","2","5","4","11","4","14","15",69,0.0114859104771007,6007.36007280959,"19"
"371830511012002","5","4","4","13","5","4","5","14","5","18","19",0,0.0207658286665772,0,"0"
"371830518001036","4","4","5","13","5","4","5","14","3","16","17",0,0.00323337915698372,0,"0"
"371830505002015","5","4","5","14","5","5","5","15","3","17","18",60,0.00515299945462997,11643.7039297743,"24"
"371830505001009","5","4","5","14","5","5","5","15","3","17","18",36,0.0102975550318998,3495.97549015072,"20"
"371830507003013","5","4","5","14","5","4","5","14","4","18","18",5,0.00656126049043768,762.048695869788,"2"
"371830507003022","5","4","5","14","5","5","5","15","4","18","19",33,0.00698063246591788,4727.36534420321,"14"
"371830507003003","5","4","5","14","5","5","5","15","3","17","18",9,0.00291305650833662,3089.53841926639,"3"
"371830541063035","3","3","2","8","3","3","2","8","4","12","12",72,0.00782762713575327,9198.18978999838,"20"
"371830528062019","3","2","3","8","3","3","4","10","3","11","13",126,0.025249497812198,4990.19825808692,"45"
"371830527061008","4","3","3","10","4","3","4","11","3","13","14",99,0.0108221844189024,9147.87589713252,"38"
"371830528064016","2","1","1","4","2","2","1","5","3","7","8",149,0.0113685969558254,13106.2786884754,"40"
"371830541053025","4","2","1","7","4","2","2","8","4","11","12",111,0.00521634674607739,21279.2602568973,"60"
"371830541054010","4","3","2","9","4","3","3","10","2","11","12",13,0.00475553869595552,2733.65455128274,"5"
"371830527073015","3","3","3","9","3","3","3","9","2","11","11",41,0.00510490306473881,8031.49432615088,"14"
"371830540121015","3","4","4","11","3","4","4","11","2","13","13",9,0.00610670688222102,1473.78942097294,"4"
"371830540041000","4","3","4","11","4","3","4","11","2","13","13",386,0.0810445471962614,4762.81271663155,"204"
"371830515011010","5","3","4","12","5","3","5","13","4","16","17",0,0.00430055951796144,0,"0"
"371830515012032","3","4","4","11","3","4","5","12","3","14","15",0,0.00162379297238686,0,"0"
"371830515022011","4","3","4","11","4","4","5","13","4","15","17",24,0.00598953844698807,4006.98655036913,"9"
"371830518003021","4","4","5","13","5","4","5","14","4","17","18",15,0.00127112405621111,11800.5791226319,"11"
"371830518001023","4","4","5","13","4","4","5","13","3","16","16",23,0.0101974575131676,2255.46416548449,"14"
"371830507001004","5","5","5","15","5","5","5","15","5","20","20",0,0.00142827494491894,0,"0"
"371830521014031","5","5","5","15","5","5","5","15","4","19","19",93,0.0152194318070712,6110.60919874754,"32"
"371830545002071","1","2","3","6","1","2","3","6","3","9","9",0,0.00348396413671112,0,"0"
"371830528061009","4","1","1","6","4","2","2","8","3","9","11",0,0.00141000498409789,0,"0"
"371830541062020","5","4","4","13","5","4","4","13","3","16","16",0,0.0533592513297323,0,"0"
"371830505003017","5","5","5","15","5","5","5","15","4","19","19",30,0.00855967626438025,3504.80544747239,"15"
"371830505002012","4","5","5","14","4","5","5","14","3","17","17",21,0.00540979838954217,3881.84521637547,"7"
"371830505001027","5","4","5","14","5","5","5","15","3","17","18",36,0.00779824976760892,4616.42048829096,"18"
"371830540141083","2","2","1","5","2","3","2","7","3","8","10",59,0.0163282511337352,3613.36921613743,"20"
"371830524041008","5","5","4","14","5","5","4","14","4","18","18",40,0.0140028278601231,2856.56585937981,"16"
"371830528072059","1","1","1","3","1","1","1","3","2","5","5",5,0.00566906602469158,881.979496838198,"2"
"371830521021027","5","4","5","14","5","4","5","14","4","18","18",35,0.0100790501279508,3472.54945214921,"14"
"371830523011022","5","5","3","13","5","5","3","13","5","18","18",0,0.000803370569357239,0,"0"
"371830527052033","2","2","4","8","2","3","5","10","4","12","14",0,0.00042933811386528,0,"0"
"371830537251021","3","5","2","10","3","5","2","10","4","14","14",220,0.0366769327676032,5998.32056279053,"88"
"371830536102022","4","5","1","10","4","5","2","11","1","11","12",36,0.00170571445250574,21105.5255744096,"22"
"371830541043032","1","2","2","5","4","3","3","10","2","7","12",143,0.0157805487759996,9061.78879010131,"42"
"371830541043005","1","2","2","5","4","3","3","10","3","8","13",0,2.7822574836384e-05,0,"0"
"371830541043040","3","4","3","10","3","4","3","10","3","13","13",104,0.0105964663412999,9814.59258683793,"30"
"371830541043024","3","4","3","10","3","4","3","10","4","14","14",0,0.000143774973712417,0,"0"
"371830541042006","4","5","3","12","4","5","3","12","4","16","16",28,0.00391145562700848,7158.4603457242,"10"
"371830545002031","4","4","4","12","4","4","4","12","4","16","16",0,0.0151256330668034,0,"0"
"371830524011040","1","5","2","8","1","5","2","8","3","11","11",0,0.00852929503739716,0,"0"
"371830536102056","2","1","1","4","2","1","1","4","1","5","5",0,0.00377956098484237,0,"0"
"371830536101088","1","5","1","7","1","5","2","8","1","8","9",2,0.00952974509492245,209.869202174738,"1"
"371830540143008","1","2","2","5","1","3","2","6","2","7","8",0,0.000791354844079553,0,"0"
"371830540181026","4","3","3","10","4","4","4","12","2","12","14",0,0.0665273051518616,0,"0"
"371830537143012","2","2","3","7","2","2","3","7","3","10","10",0,0.00308472024160829,0,"0"
"371830537262009","1","5","2","8","1","5","2","8","3","11","11",0,0.00159597480625959,0,"0"
"371830525051005","2","3","3","8","2","3","4","9","5","13","14",93,0.0185443369437724,5015.00810096266,"29"
"371830537112012","4","5","3","12","4","5","3","12","4","16","16",0,0.000876468273467802,0,"0"
"371830537241029","2","5","1","8","2","5","1","8","2","10","10",37,0.00435353272389668,8498.84504069668,"19"
"371830540133003","1","4","1","6","1","5","2","8","3","9","11",71,0.00282668334594741,25117.7763161169,"27"
"371830512003021","5","5","5","15","5","5","5","15","4","19","19",65,0.00833592822050643,7797.57194167047,"19"
"371830541102026","1","2","1","4","1","2","2","5","3","7","8",3,0.00347725257371693,862.750098360907,"1"
"371830541041036","2","2","2","6","3","3","3","9","2","8","11",166,0.019554224244184,8489.21429595314,"54"
"371830537223009","4","2","3","9","4","2","3","9","3","12","12",23,0.005569854727325,4129.37161308084,"12"
"371830525072009","2","5","2","9","2","5","2","9","3","12","12",80,0.00933874075035135,8566.46545167133,"49"
"371830537241023","2","5","1","8","2","5","1","8","2","10","10",36,0.00546197423115472,6591.0234059067,"10"
"371830537181013","1","1","1","3","4","1","2","7","1","4","8",94,0.0120360692506694,7809.85868744252,"32"
"371830524062001","2","4","3","9","3","4","4","11","3","12","14",0,0.00335030118867983,0,"0"
"371830525043019","4","5","3","12","4","5","4","13","4","16","17",0,0.00417183771846113,0,"0"
"371830540122002","3","3","4","10","3","3","4","10","2","12","12",64,0.0215103367297618,2975.3137202845,"24"
"371830527011014","5","3","4","12","5","3","4","12","2","14","14",72,0.0185897589568817,3873.10024659285,"31"
"371830527043013","5","3","4","12","5","3","4","12","2","14","14",107,0.0165381549411645,6469.88738348738,"31"
"371830523023011","2","5","3","10","2","5","3","10","3","13","13",4,0.000920123282993001,4347.24354217915,"1"
"371830526021007","3","3","4","10","3","3","4","10","3","13","13",222,0.0515720204681877,4304.65973573677,"88"
"371830537073005","4","4","3","11","4","4","4","12","5","16","17",49,0.00225440962319738,21735.1804640118,"29"
"371830537161001","4","5","4","13","4","5","4","13","5","18","18",34,0.00752157429885265,4520.33027250511,"23"
"371830507001012","5","5","5","15","5","5","5","15","5","20","20",3,0.00560810598156678,534.939961880297,"3"
"371830509001003","4","5","5","14","4","5","5","14","5","19","19",2,0.00477956979624761,418.447702462715,"1"
"371830508002009","5","5","5","15","5","5","5","15","5","20","20",86,0.0188700436635064,4557.4881295224,"33"
"371830509002024","5","5","5","15","5","5","5","15","5","20","20",0,0.000215608741611012,0,"0"
"371830540141016","2","2","1","5","3","4","2","9","4","9","13",151,0.0152639103622692,9892.61574630681,"50"
"371830523021029","5","5","5","15","5","5","5","15","5","20","20",0,0.00524234379575031,0,"0"
"371830503001004","5","5","5","15","5","5","5","15","3","18","18",57,0.00271754800888967,20974.7904410671,"41"
"371830504001003","3","4","5","12","5","5","5","15","3","15","18",0,0.00129074706482279,0,"0"
"371830524063016","1","2","2","5","4","2","3","9","2","7","11",20,0.00469810385698797,4257.03658514316,"9"
"371830528061031","2","1","1","4","2","2","1","5","4","8","9",177,0.0263991358393404,6704.76492401814,"51"
"371830515021004","4","5","4","13","4","5","4","13","5","18","18",49,0.026987566777737,1815.65090337903,"15"
"371830524062031","2","4","3","9","2","4","3","9","3","12","12",11,0.0158304540877338,694.86320095665,"5"
"371830527052028","2","2","4","8","2","3","5","10","4","12","14",0,0.00137137174941708,0,"0"
"371830514001012","5","5","5","15","5","5","5","15","4","19","19",15,0.0100790655351522,1488.23320452529,"7"
"371830521021042","2","4","4","10","2","5","4","11","3","13","14",0,0.0113611110826881,0,"0"
"371830523013027","2","5","3","10","2","5","3","10","3","13","13",0,0.0154027775567943,0,"0"
"371830545004018","3","5","4","12","3","5","4","12","3","15","15",63,0.0122251275644585,5153.32045967001,"20"
"371830540071008","3","2","3","8","3","2","3","8","5","13","13",96,0.00258456931762396,37143.5191717955,"35"
"371830525051014","3","3","3","9","3","3","4","10","5","14","15",45,0.00793573716106908,5670.5507108728,"18"
"371830523011024","3","5","3","11","3","5","3","11","4","15","15",0,0.00101502225325283,0,"0"
"371830537261007","5","5","3","13","5","5","3","13","5","18","18",65,0.00554710266271181,11717.8289193991,"29"
"371830537252003","2","5","2","9","2","5","2","9","3","12","12",5,0.00428783556032209,1166.08949425859,"2"
"371830537252026","2","5","2","9","2","5","2","9","3","12","12",0,0.00018682445857973,0,"0"
"371830524011015","1","5","2","8","1","5","2","8","4","12","12",0,0.00327788134980791,0,"0"
"371830524011053","1","5","2","8","1","5","3","9","5","13","14",0,0.0126907904207354,0,"0"
"371830540131047","3","5","3","11","3","5","3","11","5","16","16",0,0.00480329555261342,0,"0"
"371830541042031","3","3","2","8","3","3","2","8","4","12","12",128,0.0110362322992556,11598.1610869711,"31"
"371830524041001","5","5","4","14","5","5","4","14","3","17","17",36,0.0119672178388472,3008.21799057916,"12"
"371830511013000","4","5","5","14","4","5","5","14","5","19","19",278,0.0551098250578481,5044.47255472481,"1"
"371830527063026","2","1","3","6","2","1","4","7","3","9","10",0,0.00294926910771404,0,"0"
"371830504002010","5","4","5","14","5","5","5","15","4","18","19",6,0.0069772175890312,859.941649151451,"3"
"371830519003014","4","4","4","12","5","4","5","14","5","17","19",25,0.00504962900648553,4950.85875970117,"10"
"371830545002013","4","4","5","13","4","5","5","14","5","18","19",0,0.00170858126911404,0,"0"
"371830542071051","1","2","1","4","1","2","1","4","2","6","6",78,0.00787841063715306,9900.47404132086,"30"
"371830541102017","1","2","1","4","1","2","2","5","3","7","8",68,0.0036643657900071,18557.0993445685,"22"
"371830540061005","4","3","3","10","4","3","4","11","5","15","16",130,0.0502763524590132,2585.70866106446,"63"
"371830501001016","4","5","5","14","4","5","5","14","4","18","18",1,0.00952585494209016,104.977454105613,"1"
"371830501001025","4","5","5","14","4","5","5","14","4","18","18",0,0.0100941316886912,0,"0"
"371830501001024","5","5","5","15","5","5","5","15","5","20","20",0,0.0083391081324166,0,"0"
"371830501001017","5","5","5","15","5","5","5","15","4","19","19",60,0.00956105966075133,6275.45503625537,"58"
"371830501001067","5","5","5","15","5","5","5","15","5","20","20",2,0.00277531827401732,720.638068334038,"1"
"371830521022003","5","4","4","13","5","4","5","14","3","16","17",40,0.00285804261932779,13995.5925532727,"9"
"371830509003004","5","5","5","15","5","5","5","15","5","20","20",54,0.00625679711717217,8630.61387299799,"13"
"371830545003011","1","2","3","6","1","2","3","6","2","8","8",49,0.00362140800274317,13530.6488423517,"34"
"371830536102016","4","5","1","10","4","5","2","11","1","11","12",0,0.00139568953433825,0,"0"
"371830537093018","1","5","2","8","1","5","2","8","3","11","11",0,0.0116426317805832,0,"0"
"371830524072004","4","5","3","12","5","5","4","14","3","15","17",67,0.0275882006087577,2428.57448190119,"30"
"371830525051024","4","3","4","11","4","4","4","12","5","16","17",8,0.0125003984180856,639.979601644184,"4"
"371830537231002","3","2","3","8","3","2","3","8","3","11","11",254,0.0218772772864886,11610.219894999,"112"
"371830540072011","2","2","3","7","4","2","3","9","4","11","13",4,0.0314025166672053,127.378325832634,"2"
"371830525052007","2","3","3","8","2","3","4","9","4","12","13",89,0.00825284760454249,10784.1564832741,"47"
"371830508002006","4","5","5","14","4","5","5","14","5","19","19",192,0.0147373221603811,13028.1470344837,"52"
"371830540151027","2","3","2","7","2","4","3","9","3","10","12",0,0.0133337271125491,0,"0"
"371830520011002","2","2","3","7","5","3","5","13","3","10","16",0,0.00284259716505357,0,"0"
"371830514001011","4","4","5","13","4","5","5","14","3","16","17",42,0.0114321210292279,3673.85893594204,"13"
"371830537093022","1","5","2","8","1","5","2","8","3","11","11",11,0.00697573784008341,1576.8941224816,"3"
"371830525062007","2","5","2","9","2","5","2","9","3","12","12",17,0.117460447272459,144.729569780771,"9"
"371830525071014","3","2","2","7","3","2","3","8","4","11","12",0,0.0036806675327424,0,"0"
"371830540072016","2","1","2","5","2","1","3","6","5","10","11",121,0.0236307016775987,5120.45734616102,"41"
"371830537071026","4","3","3","10","4","3","4","11","3","13","14",49,0.024409425833298,2007.42124516329,"21"
"371830545001040","3","5","4","12","3","5","5","13","5","17","18",0,0.00337331486292237,0,"0"
"371830517002014","4","3","4","11","4","4","5","13","3","14","16",18,0.00580804486244198,3099.14961511367,"8"
"371830511022000","5","5","5","15","5","5","5","15","5","20","20",0,0.00873500762163169,0,"0"
"371830524062025","1","5","2","8","2","5","3","10","3","11","13",151,0.00491055451645412,30750.0913581214,"47"
"371830525071006","2","2","2","6","2","2","2","6","4","10","10",45,0.00425415724306899,10577.8882699542,"28"
"371830537073013","4","3","3","10","4","3","4","11","5","15","16",53,0.00355776433936169,14896.9956817064,"36"
"371830537232011","4","1","3","8","4","1","3","8","3","11","11",38,0.00343336322954238,11067.8647901361,"22"
"371830540181030","4","4","4","12","4","4","4","12","2","14","14",155,0.00533794907054173,29037.3695873928,"83"
"371830540151003","2","4","3","9","2","4","3","9","2","11","11",0,0.00628999363513799,0,"0"
"371830541041021","1","3","2","6","2","3","2","7","3","9","10",0,0.0255622186205995,0,"0"
"371830508002016","3","3","4","10","3","3","5","11","3","13","14",0,0.0117937080782268,0,"0"
"371830507001018","5","5","5","15","5","5","5","15","5","20","20",36,0.0100504138651343,3581.94204567903,"16"
"371830508002014","5","5","5","15","5","5","5","15","5","20","20",1,0.0228958386937669,43.6760589282208,"0"
"371830516004008","5","4","5","14","5","4","5","14","3","17","17",37,0.00653242654223029,5664.05144563134,"13"
"371830516004004","4","4","4","12","4","4","5","13","3","15","16",30,0.00973694267749774,3081.04925679912,"12"
"371830514003009","5","5","5","15","5","5","5","15","4","19","19",43,0.00806022483594129,5334.83877624096,"15"
"371830514002005","5","5","5","15","5","5","5","15","4","19","19",69,0.0115097055015034,5994.94053005851,"30"
"371830541043026","1","3","3","7","5","4","3","12","2","9","14",138,0.0185611173780335,7434.89722032137,"45"
"371830528072056","1","1","1","3","1","1","1","3","2","5","5",0,0.00285822630127163,0,"0"
"371830524061001","2","4","3","9","4","4","4","12","3","12","15",46,0.0214166673998082,2147.85984865283,"22"
"371830537171009","1","5","1","7","1","5","1","7","2","9","9",67,0.00910530257691128,7358.3496467097,"28"
"371830537252043","1","5","2","8","1","5","2","8","3","11","11",134,0.00364532855364093,36759.3751916166,"83"
"371830537132017","4","3","3","10","4","3","3","10","4","14","14",0,0.0029575592541471,0,"0"
"371830537171038","1","5","1","7","1","5","1","7","1","8","8",0,0.00338022684466591,0,"0"
"371830527043002","3","4","4","11","3","4","4","11","2","13","13",231,0.00275897338322093,83726.7954105168,"102"
"371830540142003","5","3","2","10","5","4","2","11","3","13","14",19,0.00215501555485749,8816.641697631,"8"
"371830527013007","2","3","4","9","2","3","5","10","4","13","14",0,0.0293850636800305,0,"0"
"371830540162017","4","5","3","12","5","5","4","14","2","14","16",0,0.0431085732793482,0,"0"
"371830540162001","1","4","2","7","2","4","3","9","3","10","12",0,0.00212055995050299,0,"0"
"371830523013008","2","5","3","10","2","5","3","10","3","13","13",34,0.0174315164324618,1950.49008683396,"13"
"371830541051034","5","4","2","11","5","4","3","12","4","15","16",40,0.00181122314206474,22084.5234753357,"19"
"371830541044014","1","3","3","7","5","4","3","12","3","10","15",9,0.00184717109364868,4872.31531012239,"5"
"371830541051028","4","2","2","8","4","2","2","8","4","12","12",127,0.0110073255741444,11537.7708367522,"45"
"371830527012029","2","2","4","8","2","3","5","10","3","11","13",0,0.05614437230738,0,"0"
"371830528062050","2","2","2","6","2","2","3","7","2","8","9",2,0.0016129884481185,1239.93448454819,"1"
"371830538084021","4","4","3","11","4","4","3","11","4","15","15",16,0.0100191972221552,1596.93432969056,"5"
"371830537092018","2","5","2","9","2","5","2","9","3","12","12",26,0.00273699475567412,9499.47015649148,"21"
"371830525061009","2","3","3","8","2","3","4","9","4","12","13",52,0.0166977584693144,3114.19045230298,"26"
"371830537073015","3","3","4","10","3","3","4","10","4","14","14",84,0.00547777602143768,15334.6905151397,"56"
"371830525061013","2","2","3","7","2","2","3","7","4","11","11",0,0.000503648111788314,0,"0"
"371830525042013","3","5","4","12","3","5","4","12","4","16","16",24,0.00491312116460805,4884.87851121714,"15"
"371830524011055","1","5","3","9","1","5","4","10","5","14","15",0,0.0822248192316848,0,"0"
"371830524011088","1","5","3","9","1","5","3","9","5","14","14",0,0.00956102307250131,0,"0"
"371830524072017","5","5","4","14","5","5","4","14","3","17","17",22,0.0117181823450127,1877.42427556294,"9"
"371830507003011","4","4","5","13","4","5","5","14","4","17","18",15,0.00274242363814012,5469.61446487998,"3"
"371830515021006","3","5","4","12","3","5","5","13","5","17","18",0,0.00437985949609557,0,"0"
"371830503001021","5","5","5","15","5","5","5","15","3","18","18",2,0.000586221187646861,3411.68153274732,"1"
"371830514001010","5","4","5","14","5","4","5","14","3","17","17",24,0.0066896999431135,3587.60485583603,"12"
"371830541061014","1","3","2","6","1","3","3","7","3","9","10",0,0.00159324781731144,0,"0"
"371830541102006","3","2","1","6","3","2","1","6","4","10","10",68,0.00728698567306174,9331.70491213945,"18"
"371830541102001","3","2","1","6","3","2","1","6","3","9","9",36,0.00850784564524852,4231.38847377954,"11"
"371830542071094","2","4","1","7","2","5","1","8","3","10","11",117,0.0182946262685704,6395.32058662505,"31"
"371830541101011","2","1","1","4","2","2","1","5","3","7","8",61,0.00803601798649454,7590.82422445016,"20"
"371830541102048","1","1","1","3","2","2","2","6","3","6","9",43,0.00521002176206007,8253.32445118186,"14"
"371830541044010","2","2","3","7","5","3","4","12","2","9","14",4,0.00121349705440418,3296.25851623016,"1"
"371830528062030","2","2","2","6","4","4","4","12","4","10","16",209,0.0123598874888561,16909.5390381538,"56"
"371830541043030","2","2","2","6","3","3","3","9","3","9","12",66,0.0102910404486727,6413.34569902623,"19"
"371830541132039","5","3","2","10","5","4","2","11","5","15","16",30,0.0022672802470381,13231.7123298679,"14"
"371830521012014","5","4","5","14","5","4","5","14","3","17","17",55,0.00593589992170659,9265.65486706981,"14"
"371830536101025","1","1","1","3","1","1","1","3","1","4","4",78,0.00428265762243081,18212.9898947485,"35"
"371830536101022","1","5","1","7","1","5","1","7","1","8","8",0,0.00117248231642154,0,"0"
"371830537262004","2","5","2","9","2","5","2","9","3","12","12",0,0.00740142224651037,0,"0"
"371839802001002","5","5","3","13","5","5","3","13","2","15","15",0,0.00116561186544878,0,"0"
"371830540131042","3","5","3","11","3","5","3","11","4","15","15",177,0.00481260632053699,36778.4082493268,"76"
"371830540131019","3","5","2","10","3","5","2","10","3","13","13",26,0.0253384848340275,1026.10713191044,"10"
"371830521012006","5","4","5","14","5","4","5","14","3","17","17",182,0.0385084982380532,4726.22949030382,"63"
"371830545002054","1","5","3","9","1","5","3","9","2","11","11",0,0.000171125733483099,0,"0"
"371830528061028","2","2","2","6","4","3","3","10","3","9","13",76,0.0255105033305421,2979.16505273379,"31"
"371830541131011","1","1","1","3","4","3","2","9","5","8","14",0,0.00110473133903752,0,"0"
"371830545002089","4","5","4","13","4","5","4","13","3","16","16",119,0.0102437228396542,11616.8703373486,"37"
"371830530081027","2","4","2","8","2","4","2","8","3","11","11",83,0.0190811465121105,4349.84344087088,"38"
"371830537262003","1","5","2","8","1","5","2","8","4","12","12",46,0.0270712828518189,1699.21758979033,"21"
"371830537241003","1","5","2","8","1","5","2","8","2","10","10",0,0.000811881710614411,0,"0"
"371830536101069","4","1","2","7","4","1","2","7","1","8","8",31,0.00361880809710351,8566.35642680593,"21"
"371830537132006","4","3","3","10","4","3","3","10","5","15","15",80,0.0134403693450253,5952.2173793245,"25"
"371830524011030","1","5","3","9","1","5","3","9","3","12","12",0,0.00431425839976751,0,"0"
"371830524011048","1","5","2","8","1","5","3","9","5","13","14",41,0.0019993994807331,20506.1571712357,"14"
"371830525043015","5","5","4","14","5","5","4","14","4","18","18",15,0.0148047485227045,1013.18843592622,"6"
"371830525032009","2","2","3","7","2","2","3","7","5","12","12",0,0.000246497285897495,0,"0"
"371830530091003","2","4","3","9","2","4","3","9","3","12","12",3,0.0199190112616757,150.609885229194,"2"
"371830527043003","3","3","3","9","3","4","4","11","2","11","13",204,0.00938609617365792,21734.2754885174,"81"
"371830541043023","2","2","2","6","2","3","3","8","3","9","11",10,0.000640674620519298,15608.5471153743,"2"
"371830540181018","3","3","4","10","3","3","4","10","2","12","12",0,0.0299552107000458,0,"0"
"371830504001021","4","4","5","13","5","4","5","14","3","16","17",68,0.0108490625668521,6267.82264190871,"37"
"371830505001010","5","4","5","14","5","5","5","15","3","17","18",26,0.00690303298331399,3766.46034617641,"15"
"371830505003020","5","5","5","15","5","5","5","15","4","19","19",34,0.00798643466276327,4257.21882613338,"16"
"371830519001029","3","4","4","11","5","4","5","14","4","15","18",2,0.00202508389999739,987.613402092912,"1"
"371830520021010","4","4","4","12","4","5","5","14","4","16","18",43,0.0123909312586898,3470.27992507375,"15"
"371830526023006","3","3","4","10","3","3","4","10","3","13","13",43,0.0224053760590576,1919.18224834333,"25"
"371830528033017","2","2","3","7","2","3","4","9","3","10","12",121,0.00961023295058469,12590.7457833931,"39"
"371830541102044","1","1","1","3","2","2","2","6","3","6","9",0,0.000120469958327953,0,"0"
"371830541044011","3","3","3","9","3","3","3","9","2","11","11",49,0.016210967432033,3022.64502136842,"19"
"371830541063039","4","3","2","9","4","3","2","9","4","13","13",8,0.0050701532425548,1577.86157878906,"3"
"371830545004000","4","5","4","13","4","5","4","13","3","16","16",17,0.0100073391685065,1698.75325636005,"8"
"371830506001006","5","4","5","14","5","5","5","15","3","17","18",41,0.00378388687135862,10835.4190793444,"16"
"371830519002018","4","4","5","13","4","4","5","13","4","17","17",44,0.0084972385782569,5178.15283103726,"16"
"371830519002001","4","3","4","11","4","3","5","12","4","15","16",52,0.00996874742102485,5216.30228992742,"21"
"371830519001014","5","4","5","14","5","4","5","14","4","18","18",83,0.0193553633364088,4288.21709814515,"36"
"371830501001089","5","5","5","15","5","5","5","15","5","20","20",3,0.00505609197186588,593.343637080418,"2"
"371830519001005","2","4","4","10","5","5","5","15","4","14","19",0,0.000974841472177903,0,"0"
"371830527052035","2","2","4","8","2","3","5","10","5","13","15",0,0.00838781759626292,0,"0"
"371830518001013","5","4","5","14","5","4","5","14","4","18","18",94,0.0153253556002387,6133.62602813185,"47"
"371830521014027","4","4","5","13","4","4","5","13","4","17","17",80,0.0205924918816944,3884.91108602139,"27"
"371830541051032","4","4","2","10","4","4","3","11","4","14","15",16,0.000730313962443982,21908.3857392734,"6"
"371830541051039","3","3","2","8","3","3","2","8","4","12","12",0,0.0032656941684116,0,"0"
"371830521014009","4","5","5","14","4","5","5","14","4","18","18",1,0.00165928645627494,602.668693050733,"1"
"371830519002002","4","3","4","11","4","3","5","12","5","16","17",2,0.000404136736373267,4948.82008982418,"1"
"371830528062026","2","1","2","5","2","2","3","7","2","7","9",59,0.00527102518891881,11193.2684601915,"18"
"371830545003021","2","4","3","9","2","4","3","9","3","12","12",363,0.00133644994690384,271615.110495506,"202"
"371830540141041","2","2","1","5","3","4","2","9","4","9","13",0,0.00232398888574696,0,"0"
"371830540171044","3","5","3","11","3","5","3","11","2","13","13",2,0.00378557087060743,528.321901335605,"1"
"371830540143002","1","2","1","4","1","3","2","6","2","6","8",58,0.0029915850416393,19387.7156065126,"25"
"371830515022015","4","5","4","13","4","5","5","14","4","17","18",40,0.0110792449937151,3610.35431770764,"14"
"371830501001001","5","4","5","14","5","5","5","15","4","18","19",17,0.00496626817410186,3423.09343837929,"11"
"371830506003006","5","5","5","15","5","5","5","15","5","20","20",34,0.00681282841409275,4990.58510407644,"21"
"371830507001002","5","5","5","15","5","5","5","15","5","20","20",6,0.00642753030135932,933.484514064616,"3"
"371830520024008","4","4","5","13","4","4","5","13","3","16","16",0,0.00154244825115926,0,"0"
"371830540141053","1","3","1","5","3","4","2","9","3","8","12",16,0.000360224826432328,44416.7054182917,"5"
"371830540141055","1","3","1","5","3","4","2","9","3","8","12",125,0.00454747371305351,27487.7894601541,"75"
"371830524081003","4","5","4","13","4","5","5","14","4","17","18",24,0.00995401977494288,2411.08622874297,"5"
"371830505003015","5","4","5","14","5","5","5","15","5","19","20",52,0.0121093518663964,4294.20175197822,"22"
"371830527063028","1","3","4","8","2","3","4","9","3","11","12",0,0.0202487579155786,0,"0"
"371830501001063","5","5","5","15","5","5","5","15","5","20","20",1,0.00501835044675362,199.268666190282,"1"
"371830515012019","3","2","4","9","3","3","5","11","4","13","15",56,0.0188317451263853,2973.70209846022,"21"
"371830515011023","3","3","4","10","3","3","5","11","3","13","14",30,0.00881495472014819,3403.30732855944,"15"
"371830528033005","1","2","3","6","4","4","4","12","3","9","15",121,0.0146009888283895,8287.10996372607,"40"
"371830537221009","2","2","2","6","2","2","2","6","3","9","9",42,0.0042644639305232,9848.83462124794,"20"
"371830541102014","5","4","1","10","5","5","2","12","5","15","17",0,0.00313475484939322,0,"0"
"371830536101077","2","5","1","8","2","5","1","8","1","9","9",32,0.0016977850662241,18848.0866256932,"24"
"371830527063020","2","2","3","7","2","3","4","9","3","10","12",181,0.0310223143658944,5834.50989069305,"59"
"371830541044022","4","4","3","11","4","4","4","12","3","14","15",0,0.0119038634211797,0,"0"
"371830523012006","5","5","4","14","5","5","4","14","5","19","19",28,0.00094320392972196,29686.0510412143,"14"
"371830545003010","2","2","3","7","2","2","3","7","3","10","10",107,0.0122617075427874,8726.35394594287,"55"
"371830530031000","1","2","2","5","3","2","2","7","2","7","9",0,0.00445600778935201,0,"0"
"371830524011002","5","5","3","13","5","5","3","13","5","18","18",0,0.00126584496853964,0,"0"
"371830516003013","4","4","5","13","4","4","5","13","3","16","16",98,0.0196790974721881,4979.90317586975,"39"
"371830503001025","5","5","5","15","5","5","5","15","3","18","18",36,0.00495191034299416,7269.92160731099,"21"
"371830503002003","5","5","5","15","5","5","5","15","3","18","18",165,0.00428074886295794,38544.657788214,"134"
"371830503001015","5","5","5","15","5","5","5","15","3","18","18",39,0.0070174620429903,5557.56479494704,"15"
"371830503001016","5","5","5","15","5","5","5","15","3","18","18",27,0.00419206247292973,6440.74370893866,"14"
"371830524082001","5","5","4","14","5","5","5","15","4","18","19",99,0.00991426586505149,9985.61077013097,"48"
"371830511022008","5","5","5","15","5","5","5","15","5","20","20",0,0.0254083016703496,0,"0"
"371830521011031","2","2","3","7","2","2","3","7","2","9","9",0,2.34687803960922e-05,0,"0"
"371830521011012","2","2","4","8","2","3","4","9","3","11","12",9,0.00572334360977621,1572.50736870434,"1"
"371830541052018","2","3","3","8","2","3","3","8","3","11","11",36,0.00576835256052181,6240.95001515362,"15"
"371830527052019","4","2","4","10","4","3","5","12","3","13","15",57,0.00822848103682559,6927.1594289278,"18"
"371830537261010","4","5","3","12","4","5","3","12","5","17","17",0,0.000513797954752641,0,"0"
"371830537142004","2","3","3","8","2","3","3","8","3","11","11",0,0.00280497939173781,0,"0"
"371830525052016","4","3","4","11","4","4","4","12","5","16","17",0,0.000991215480165755,0,"0"
"371830537072016","5","4","4","13","5","4","4","13","4","17","17",89,0.00167046010320201,53278.734301646,"45"
"371830537161005","4","5","4","13","4","5","4","13","5","18","18",212,0.0451476834424862,4695.70050631873,"109"
"371830540182008","1","3","3","7","1","4","3","8","2","9","10",0,0.00268295561032151,0,"0"
"371830540082011","3","3","3","9","3","4","4","11","2","11","13",38,0.00163530365320821,23237.2745731045,"16"
"371830540134022","1","4","1","6","1","4","1","6","5","11","11",8,0.000990218292427374,8079.02667642019,"5"
"371830537152005","3","2","3","8","3","3","3","9","4","12","13",251,0.0775570375009242,3236.32784448489,"108"
"371830537222014","2","2","3","7","2","2","3","7","3","10","10",55,0.00808050501654134,6806.50527255552,"22"
"371839802001012","1","5","1","7","1","5","1","7","2","9","9",0,0.00507943966308591,0,"0"
"371830537142018","5","3","3","11","5","3","3","11","5","16","16",29,0.00687103137849543,4220.61818706906,"13"
"371830540143007","1","2","1","4","1","3","2","6","2","6","8",60,0.004321854279596,13882.9298996191,"25"
"371830540132040","1","4","1","6","1","5","2","8","5","11","13",0,0.00159683248771677,0,"0"
"371830511013001","4","5","5","14","4","5","5","14","5","19","19",12,0.0018843407509591,6368.27494915247,"0"
"371830515011036","3","3","4","10","4","3","5","12","4","14","16",0,0.000870903447319205,0,"0"
"371830541102027","2","1","1","4","2","2","1","5","3","7","8",70,0.0129376398707484,5410.56952421964,"22"
"371830542071025","1","2","1","4","1","2","1","4","2","6","6",0,0.00163428021446285,0,"0"
"371830535161003","1","3","2","6","3","4","2","9","2","8","11",0,0.00383416912247413,0,"0"
"371830537171019","1","5","1","7","2","5","1","8","1","8","9",47,0.0336215473658903,1397.9130552356,"16"
"371830542091051","2","1","1","4","2","1","1","4","3","7","7",99,0.00791383084685736,12509.7442585993,"57"
"371830541102023","1","1","1","3","2","2","1","5","2","5","7",3,0.00207089032801279,1448.65228226681,"1"
"371830527071005","3","3","3","9","3","3","3","9","2","11","11",45,0.0198302568389995,2269.25956458113,"20"
"371830545004002","4","5","4","13","4","5","4","13","3","16","16",93,0.0168487432819897,5519.6995077616,"37"
"371830545002020","4","4","5","13","4","4","5","13","4","17","17",0,0.00476206458197627,0,"0"
"371830514001009","5","4","5","14","5","5","5","15","3","17","18",57,0.0182385960952825,3125.24054495309,"24"
"371830514001018","5","5","5","15","5","5","5","15","3","18","18",0,0.00151366435411031,0,"0"
"371830514002009","5","5","5","15","5","5","5","15","4","19","19",91,0.0146790851208401,6199.29643100208,"35"
"371830517003011","4","3","4","11","5","3","5","13","4","15","17",65,0.0209700943139948,3099.65224889909,"25"
"371830507002006","5","5","5","15","5","5","5","15","5","20","20",35,0.00747004723978559,4685.37866984153,"20"
"371830507002003","5","5","5","15","5","5","5","15","4","19","19",0,0.00770099804060258,0,"0"
"371830528064012","1","1","1","3","1","1","1","3","4","7","7",39,0.0033167855655525,11758.3724450102,"10"
"371830523022008","5","5","4","14","5","5","4","14","4","18","18",30,0.0127516081658444,2352.64443588818,"15"
"371830537251017","2","5","2","9","2","5","2","9","3","12","12",80,0.00546767676142031,14631.4428395761,"47"
"371830537192001","1","1","1","3","2","1","1","4","1","4","5",171,0.0257372385209278,6644.06944284074,"54"
"371830537181012","1","1","1","3","3","1","1","5","1","4","6",47,0.00772284766166949,6085.83803009262,"15"
"371830540171037","2","4","3","9","2","4","3","9","2","11","11",6,0.00197252173309305,3041.79158046162,"6"
"371830541043016","3","3","3","9","5","4","4","13","2","11","15",2,0.00361974928334185,552.524454995829,"1"
"371830520021005","3","4","4","11","4","5","5","14","4","15","18",30,0.0123893582602753,2421.432924108,"17"
"371830518002001","5","4","5","14","5","4","5","14","4","18","18",67,0.0102349155604276,6546.21912652112,"26"
"371830524012012","5","5","5","15","5","5","5","15","5","20","20",0,0.00626628858761857,0,"0"
"371830527013014","3","3","4","10","3","4","5","12","4","14","16",0,0.00277349660309286,0,"0"
"371830518001015","5","4","5","14","5","4","5","14","3","17","17",38,0.00587176251933344,6471.65137807953,"16"
"371830520022004","5","4","5","14","5","4","5","14","5","19","19",155,0.0220307490626439,7035.62096591728,"47"
"371830527052026","3","3","4","10","3","3","5","11","5","15","16",0,0.015447404062508,0,"0"
"371830511021011","4","5","5","14","4","5","5","14","4","18","18",0,0.00725827834218622,0,"0"
"371830510001011","5","5","5","15","5","5","5","15","5","20","20",54,0.00459641180898837,11748.294592404,"32"
"371830519001046","3","4","5","12","4","4","5","13","3","15","16",0,0.000500747431687349,0,"0"
"371830526011004","3","3","3","9","4","3","4","11","4","13","15",0,0.000432340100028162,0,"0"
"371830527063000","4","3","3","10","4","4","4","12","3","13","15",74,0.0255623669764669,2894.88059021003,"21"
"371830542091071","3","1","1","5","3","1","1","5","3","8","8",7,0.000110105309648355,63575.498968724,"2"
"371830530031014","1","3","2","6","2","4","2","8","2","8","10",0,0.0129088934995118,0,"0"
"371830523013010","3","5","4","12","3","5","4","12","4","16","16",0,0.00392607523907255,0,"0"
"371830523023006","2","5","3","10","3","5","3","11","3","13","14",62,0.00454632980708276,13637.3740205583,"21"
"371830523023034","3","5","3","11","3","5","3","11","3","14","14",0,0.00276200193240179,0,"0"
"371830545003013","2","2","3","7","2","2","3","7","3","10","10",0,0.00253104978289943,0,"0"
"371830508001010","5","5","5","15","5","5","5","15","5","20","20",55,0.0142923041836972,3848.22484136161,"34"
"371830507002013","4","5","5","14","4","5","5","14","4","18","18",78,0.00729890077323244,10686.5406755566,"27"
"371830517002001","4","4","4","12","4","5","5","14","5","17","19",89,0.0259285995504482,3432.50316419274,"31"
"371830521021034","3","4","4","11","3","4","4","11","3","14","14",99,0.0100974587809164,9804.44705425333,"31"
"371830528033021","1","1","1","3","1","1","1","3","2","5","5",0,0.0155985288707378,0,"0"
"371830541054014","3","3","2","8","3","3","3","9","3","11","12",2,0.00414894139330387,482.050675198227,"1"
"371830541044007","2","3","3","8","4","3","3","10","2","10","12",69,0.0258265523824545,2671.66902411937,"27"
"371830528063018","1","1","2","4","3","3","3","9","5","9","14",0,0.000170584286005252,0,"0"
"371830518003014","4","4","5","13","4","4","5","13","4","17","17",54,0.00915308054596803,5899.65309808043,"24"
"371830504001025","5","4","5","14","5","4","5","14","3","17","17",0,0.0024918985995533,0,"0"
"371830504001026","5","4","5","14","5","4","5","14","3","17","17",69,0.01563966696348,4411.85865153786,"36"
"371830505002021","5","4","5","14","5","4","5","14","3","17","17",155,0.0193967831195413,7991.01578054174,"79"
"371830527063018","2","3","3","8","2","3","4","9","3","11","12",0,0.000218078222617971,0,"0"
"371830528062055","5","2","2","9","5","3","3","11","4","13","15",0,0.00153837013277352,0,"0"
"371830541063024","3","3","2","8","3","3","2","8","4","12","12",94,0.0112945307472007,8322.61225401485,"30"
"371830542091055","2","1","1","4","2","1","1","4","3","7","7",0,0.000878100034859944,0,"0"
"371830541103018","1","1","1","3","2","2","1","5","2","5","7",33,0.00641385475986919,5145.11182985894,"13"
"371830542071084","1","4","1","6","1","4","1","6","2","8","8",14,0.00219954616507426,6364.94938014968,"4"
"371830542081121","2","4","1","7","2","5","1","8","3","10","11",0,0.0102270138849774,0,"0"
"371830538084024","2","4","3","9","2","4","3","9","3","12","12",0,0.013151160944463,0,"0"
"371830538082002","2","2","2","6","2","2","2","6","3","9","9",0,0.0101214779126458,0,"0"
"371830545003028","5","4","4","13","5","4","4","13","4","17","17",47,0.0119473500552761,3933.92675217079,"13"
"371830523022013","2","5","3","10","3","5","3","11","3","13","14",48,0.00451551461902391,10630.0176280629,"18"
"371830541041028","2","3","2","7","3","4","3","10","3","10","13",0,0.00335035950001638,0,"0"
"371830538083028","4","5","2","11","4","5","3","12","4","15","16",0,0.000891189933721365,0,"0"
"371830536101046","1","5","1","7","1","5","1","7","1","8","8",58,0.00782680478888115,7410.4314039358,"18"
"371830536101061","2","5","1","8","2","5","1","8","1","9","9",21,0.00236686217193425,8872.50649784914,"15"
"371830541062019","4","3","3","10","4","3","4","11","3","13","14",0,0.0154046857181904,0,"0"
"371830538082013","1","1","2","4","5","2","3","10","3","7","13",58,0.0517873155952947,1119.96536860987,"18"
"371830537113014","3","5","3","11","3","5","3","11","5","16","16",60,0.010361327205734,5790.76394448732,"35"
"371830530081061","2","4","2","8","2","4","2","8","3","11","11",8,0.00421289407087946,1898.9321510118,"1"
"371830516005008","4","4","5","13","5","4","5","14","3","16","17",3,0.00149393225485097,2008.12318648229,"1"
"371830537093056","1","5","1","7","1","5","1","7","2","9","9",3,0.0136556055025261,219.690001988198,"1"
"371830507001023","5","5","5","15","5","5","5","15","5","20","20",32,0.00296183081809069,10804.1282454575,"15"
"371830540151008","3","3","3","9","3","3","3","9","2","11","11",0,0.089427814295654,0,"0"
"371830527012024","3","3","4","10","3","3","4","10","3","13","13",0,0.0168623799026612,0,"0"
"371830540151014","5","4","3","12","5","4","3","12","2","14","14",2,0.00211788643339401,944.337698407607,"1"
"371830512001006","5","5","5","15","5","5","5","15","3","18","18",70,0.00919436639554961,7613.35767888067,"45"
"371830524081001","4","4","4","12","4","5","5","14","5","17","19",54,0.00729026139792377,7407.14180912346,"23"
"371830511021000","5","5","5","15","5","5","5","15","4","19","19",0,0.00306067754183044,0,"0"
"371830523021051","4","5","5","14","4","5","5","14","4","18","18",0,0.00313771167620736,0,"0"
"371830540132034","1","4","1","6","1","5","2","8","5","11","13",0,0.0013472213539431,0,"0"
"371830540132054","1","4","1","6","1","5","2","8","5","11","13",50,0.00589261806909303,8485.19272990923,"12"
"371830527012004","2","3","4","9","2","3","4","9","2","11","11",21,0.000831642748839798,25251.227199776,"10"
"371830540151048","4","4","3","11","4","4","3","11","2","13","13",0,0.00572681924242261,0,"0"
"371830541041006","3","4","1","8","3","4","2","9","5","13","14",2,0.000219369932865276,9117.01970218627,"1"
"371830540134026","1","4","1","6","1","4","1","6","5","11","11",40,0.0040406372785175,9899.42854130076,"22"
"371830540132048","1","4","1","6","1","4","1","6","5","11","11",0,0.000658758808452258,0,"0"
"371830540132046","1","4","1","6","1","4","1","6","5","11","11",224,0.0245152880173348,9137.15555132817,"54"
"371830526012008","4","4","4","12","4","4","4","12","4","16","16",29,0.00797291793726735,3637.31324317876,"10"
"371830526011017","3","4","4","11","3","4","4","11","4","15","15",25,0.00799334046555943,3127.603547943,"12"
"371830503002010","4","5","5","14","5","5","5","15","4","18","19",15,0.00494585696262332,3032.84144959257,"9"
"371830510002013","5","5","5","15","5","5","5","15","5","20","20",38,0.00535052819279549,7102.10256459674,"20"
"371830501001035","4","5","5","14","4","5","5","14","4","18","18",117,0.00749099751955901,15618.7476627128,"76"
"371830540163004","4","5","4","13","4","5","4","13","5","18","18",46,0.00705267784949641,6522.3452682281,"16"
"371830540131038","2","5","2","9","2","5","2","9","4","13","13",23,0.0114650627858328,2006.09455261081,"11"
"371830505001006","5","4","5","14","5","4","5","14","3","17","17",52,0.0183877156684978,2827.97498816493,"30"
"371830506003001","5","4","5","14","5","5","5","15","4","18","19",38,0.0046741186883762,8129.8748563018,"19"
"371830511011007","4","5","4","13","4","5","5","14","5","18","19",0,0.00259483585053435,0,"0"
"371830520011014","3","3","4","10","4","4","5","13","4","14","17",0,0.00762712599748177,0,"0"
"371830524012016","3","5","4","12","3","5","4","12","4","16","16",0,0.00314989031375371,0,"0"
"371830508001006","5","5","5","15","5","5","5","15","5","20","20",0,0.000281456182557749,0,"0"
"371830523021030","3","5","4","12","3","5","5","13","5","17","18",0,0.00382002834473058,0,"0"
"371830510001015","4","5","5","14","4","5","5","14","4","18","18",0,0.00119983080774041,0,"0"
"371830526011020","4","3","3","10","4","3","4","11","5","15","16",167,0.0787357554829629,2121.01857632059,"66"
"371830527012026","2","2","4","8","2","3","4","9","3","11","12",13,0.00535401511867193,2428.08429036052,"6"
"371830541061023","1","3","4","8","2","3","5","10","4","12","14",0,5.76378900279603e-05,0,"0"
"371830541131019","5","3","2","10","5","3","2","10","5","15","15",0,0.00338542588308143,0,"0"
"371830527073004","3","3","3","9","3","3","4","10","2","11","12",12,0.016318912954583,735.343097508829,"6"
"371830501001038","4","5","5","14","4","5","5","14","4","18","18",0,0.00846818528320974,0,"0"
"371830501001079","5","5","5","15","5","5","5","15","5","20","20",0,0.00844996695691888,0,"0"
"371830501001039","5","5","5","15","5","5","5","15","4","19","19",0,0.00857708498502493,0,"0"
"371830501001056","5","5","5","15","5","5","5","15","4","19","19",0,0.00525768476429037,0,"0"
"371830526023009","2","3","4","9","2","3","5","10","3","12","13",5,0.0126013370746385,396.783291359059,"2"
"371830538071002","1","1","2","4","1","1","2","4","2","6","6",0,0.0464756107965658,0,"0"
"371830545001014","5","5","5","15","5","5","5","15","5","20","20",53,0.0200775266645029,2639.76738199054,"18"
"371830541051037","4","3","2","9","4","3","2","9","4","13","13",0,0.0231255835328597,0,"0"
"371830527063011","2","1","3","6","2","2","4","8","3","9","11",7,0.00808427949265123,865.878029868109,"3"
"371830541051046","5","4","2","11","5","4","3","12","5","16","17",1,0.00932670010981061,107.219057997599,"1"
"371830541051000","3","3","2","8","3","3","2","8","4","12","12",108,0.0153345552874317,7042.91699209025,"43"
"371830527061011","3","2","3","8","3","2","4","9","3","11","12",36,0.00404470180958535,8900.53252249282,"10"
"371830528062021","4","2","3","9","4","3","4","11","3","12","14",16,0.00418569035176899,3822.54745462429,"5"
"371830528062015","2","1","2","5","2","2","3","7","2","7","9",32,0.0040224106428661,7955.42843363178,"13"
"371830542091077","2","1","1","4","2","2","1","5","3","7","8",7,0.00487592395220384,1435.62534375379,"2"
"371830541103004","2","1","1","4","2","2","1","5","3","7","8",0,0.00697425623735566,0,"0"
"371830542081082","1","2","1","4","1","2","1","4","2","6","6",0,0.00604120998444839,0,"0"
"371830541101005","3","1","1","5","3","1","1","5","3","8","8",34,0.0101115480187091,3362.49206719789,"14"
"371830536101031","1","1","1","3","1","1","1","3","1","4","4",57,0.00756695202801669,7532.75556511487,"34"
"371830537261003","3","5","3","11","3","5","3","11","4","15","15",92,0.0214512032208301,4288.8037119831,"36"
"371830537121016","5","3","3","11","5","3","3","11","5","16","16",40,0.00483852694149397,8266.97887263378,"11"
"371830537241026","2","5","2","9","2","5","2","9","2","11","11",23,0.00219867810705758,10460.8309539136,"12"
"371830537111017","3","5","2","10","3","5","2","10","2","12","12",123,0.0143856704303156,8550.1750228336,"66"
"371830540182007","2","2","3","7","2","2","3","7","2","9","9",2,0.0219556517806747,91.0927181747525,"1"
"371830540012016","3","2","4","9","3","3","4","10","2","11","12",29,0.00682531145586112,4248.89035284928,"9"
"371830537093008","2","5","1","8","2","5","1","8","2","10","10",31,0.00246564037822914,12572.7986423814,"16"
"371830537091010","1","5","2","8","1","5","2","8","3","11","11",41,0.0044239000864119,9267.84041211336,"28"
"371830537073012","4","3","3","10","4","3","4","11","5","15","16",29,0.00078938188235413,36737.6052684601,"17"
"371830537142028","3","3","3","9","3","3","3","9","4","13","13",9,0.00901264416353821,998.597063934981,"3"
"371830537071019","3","3","3","9","3","3","3","9","3","12","12",49,0.016789449058564,2918.49957846032,"19"
"371830515011001","4","3","4","11","4","3","5","12","5","16","17",3,0.0173660092229914,172.751261471646,"2"
"371830524011097","1","5","2","8","2","5","3","10","3","11","13",0,0.00595566876139627,0,"0"
"371830525043030","5","5","4","14","5","5","4","14","4","18","18",181,0.016718607674394,10826.2603875332,"122"
"371830525043008","4","2","3","9","4","2","4","10","4","13","14",0,0.0024831100044702,0,"0"
"371830540161012","3","4","2","9","3","4","2","9","3","12","12",87,0.0130033402719073,6690.58858576181,"39"
"371830540142011","3","3","1","7","3","4","2","9","3","10","12",0,0.00374598986178234,0,"0"
"371830536101092","1","1","1","3","1","1","1","3","1","4","4",0,0.00237028181461001,0,"0"
"371830536101039","3","1","1","5","3","1","1","5","1","6","6",0,0.000744310368542746,0,"0"
"371830536101055","2","5","1","8","2","5","1","8","1","9","9",0,0.000702314607444991,0,"0"
"371830536102112","5","5","2","12","5","5","2","12","1","13","13",0,0.000226381894422766,0,"0"
"371830540132004","3","5","1","9","3","5","2","10","4","13","14",46,0.00842590264320233,5459.35574476533,"11"
"371830540151005","2","3","2","7","2","4","3","9","2","9","11",0,0.00358585995994566,0,"0"
"371830530081018","1","3","2","6","2","4","2","8","3","9","11",0,0.00418321819153856,0,"0"
"371830530081059","3","5","2","10","3","5","2","10","4","14","14",19,0.00879904937691531,2159.32417084138,"8"
"371830542071101","3","5","1","9","3","5","1","9","3","12","12",166,0.0230138629893215,7213.04372399474,"45"
"371830541102038","1","1","1","3","1","2","2","5","3","6","8",48,0.00446099376320037,10759.9343437692,"14"
"371830541041029","2","2","2","6","3","3","3","9","2","8","11",1,0.00186981966759251,534.81093248289,"1"
"371830541042010","5","5","3","13","5","5","3","13","4","17","17",0,0.000787872674831106,0,"0"
"371830540162009","3","5","3","11","3","5","3","11","5","16","16",112,0.0195007411002318,5743.37146595258,"38"
"371830540123005","3","4","4","11","3","5","4","12","2","13","14",15,0.00672882704442213,2229.21467604584,"10"
"371830507002000","5","4","5","14","5","5","5","15","4","18","19",58,0.00682907975309172,8493.09161658886,"22"
"371830507003031","5","5","5","15","5","5","5","15","4","19","19",14,0.00297357864573517,4708.13173886602,"6"
"371830517002010","4","4","5","13","5","5","5","15","4","17","19",32,0.00899418043884177,3557.85612903724,"13"
"371830516001012","3","4","5","12","4","4","5","13","3","15","16",46,0.0146081529386583,3148.92650653101,"24"
"371830514005005","5","4","5","14","5","4","5","14","3","17","17",71,0.00436044780240661,16282.7313196626,"22"
"371830528064007","2","1","1","4","2","1","1","4","4","8","8",96,0.00764477316183543,12557.5995477872,"28"
"371830528072021","4","2","2","8","4","3","2","9","3","11","12",28,0.00349102762435243,8020.56099604594,"8"
"371830516005013","4","4","5","13","5","5","5","15","3","16","18",0,0.00367372095696487,0,"0"
"371830516005020","4","4","5","13","5","4","5","14","3","16","17",62,0.0121723135021624,5093.52638584158,"26"
"371830518002030","5","4","5","14","5","4","5","14","3","17","17",11,0.00598890143297864,1836.73084673378,"8"
"371830541063038","4","3","2","9","4","3","2","9","4","13","13",34,0.00458390745992485,7417.25270356078,"12"
"371830527073007","3","4","3","10","3","4","4","11","2","12","13",22,0.00352159934287303,6247.16154735868,"6"
"371830541051030","5","4","2","11","5","4","3","12","4","15","16",23,0.00267533078367356,8597.06774966278,"10"
"371830541062009","3","3","3","9","3","4","3","10","3","12","13",0,0.00853079276761,0,"0"
"371830540121001","3","3","3","9","3","3","3","9","3","12","12",131,0.073388232436811,1785.02732182294,"49"
"371830540171028","1","1","2","4","1","2","2","5","2","6","7",0,0.00753835772245204,0,"0"
"371830540171003","4","5","3","12","4","5","3","12","2","14","14",0,0.0226704060555541,0,"0"
"371830540141078","1","2","1","4","1","3","2","6","3","7","9",0,4.33611778062411e-06,0,"0"
"371830541042011","5","5","3","13","5","5","3","13","4","17","17",27,0.00645524390304328,4182.64598604416,"12"
"371830509001005","5","5","5","15","5","5","5","15","5","20","20",0,0.00474346666185372,0,"0"
"371830545001016","5","5","5","15","5","5","5","15","5","20","20",0,0.011354681291095,0,"0"
"371830528062022","4","2","2","8","4","3","3","10","3","11","13",18,0.00628030550890845,2866.10260829946,"6"
"371830526021016","3","2","4","9","3","3","4","10","3","12","13",83,0.0240569913129908,3450.14049845793,"37"
"371830520021011","3","4","4","11","3","4","5","12","4","15","16",223,0.0754128022329368,2957.05760026252,"83"
"371830541062012","4","2","2","8","4","2","2","8","4","12","12",0,0.00403820139392688,0,"0"
"371830527051005","4","3","4","11","4","3","4","11","2","13","13",0,0.00805098569397533,0,"0"
"371830527012038","3","3","4","10","3","4","5","12","4","14","16",0,0.00258012064077998,0,"0"
"371830536102110","5","5","2","12","5","5","2","12","1","13","13",32,0.00436208927138049,7335.93422994592,"18"
"371830541041033","2","2","1","5","2","2","2","6","3","8","9",6,0.0364920247984015,164.419487083732,"2"
"371830540141075","3","3","1","7","3","4","2","9","4","11","13",0,6.70004286151127e-05,0,"0"
"371830541042007","5","5","3","13","5","5","3","13","4","17","17",33,0.00460873331088181,7160.31884988501,"14"
"371830540134009","1","4","1","6","1","4","1","6","5","11","11",44,0.00617848644474902,7121.48523646836,"13"
"371830528063015","3","1","1","5","3","2","2","7","3","8","10",57,0.011544838750299,4937.27121121753,"22"
"371830523023016","2","4","3","9","2","4","3","9","2","11","11",118,0.00221554442011154,53260.0470244959,"40"
"371830537093006","2","5","1","8","2","5","1","8","2","10","10",0,0.00136120367130541,0,"0"
"371830523013021","3","5","3","11","3","5","3","11","3","14","14",0,0.0131743368036969,0,"0"
"371830523023037","2","4","3","9","3","4","3","10","2","11","12",125,0.0187623548346262,6662.27672921474,"42"
"371830530081050","1","3","2","6","1","3","2","6","3","9","9",113,0.0111192387582513,10162.5662023082,"32"
"371830537072004","3","3","3","9","3","3","4","10","5","14","15",140,0.0436864242553661,3204.65687879693,"79"
"371830537092031","2","5","2","9","2","5","2","9","3","12","12",0,0.000464645202733838,0,"0"
"371830536102029","3","5","1","9","3","5","1","9","1","10","10",0,0.0050891310174466,0,"0"
"371830537132007","4","2","2","8","4","2","3","9","4","12","13",228,0.0244809541968457,9313.36246809272,"120"
"371830527073003","3","3","3","9","3","3","4","10","2","11","12",36,0.0188508409085696,1909.72912957079,"14"
"371830535211000","5","5","3","13","5","5","3","13","5","18","18",49,0.0200477625431766,2444.16302789248,"15"
"371830537143009","3","3","3","9","3","3","3","9","3","12","12",0,0.00089799986598679,0,"0"
"371830509001019","5","5","5","15","5","5","5","15","5","20","20",22,0.00558092778352548,3941.99689609719,"9"
"371830528072097","1","1","1","3","1","1","1","3","2","5","5",0,0.0312586209673562,0,"0"
"371830528033025","2","2","4","8","2","3","4","9","3","11","12",99,0.0088124649657311,11234.0872145285,"28"
"371830528064051","2","1","1","4","2","2","1","5","4","8","9",11,0.00103144200248405,10664.6810712657,"2"
"371830521013001","4","4","5","13","4","4","5","13","4","17","17",0,0.00221361057601204,0,"0"
"371830528033016","2","2","3","7","2","3","4","9","3","10","12",111,0.0084140636796153,13192.1987076137,"27"
"371830523023009","2","5","3","10","3","5","3","11","3","13","14",0,0.000545421593367303,0,"0"
"371830545004006","2","4","3","9","2","4","3","9","3","12","12",3,0.00327948886811748,914.776698639042,"1"
"371830537071017","2","2","3","7","2","2","3","7","3","10","10",0,0.00601370867822547,0,"0"
"371830530081056","2","4","2","8","2","4","2","8","3","11","11",0,0.0038872284971917,0,"0"
"371830525071003","2","2","2","6","2","2","2","6","4","10","10",45,0.0286488057626801,1570.74610274401,"18"
"371830525072014","1","5","2","8","1","5","2","8","3","11","11",63,0.00573343483047557,10988.1775694265,"41"
"371830537091012","1","5","1","7","1","5","1","7","3","10","10",0,0.000320383897866594,0,"0"
"371830525062005","3","2","3","8","3","2","3","8","3","11","11",0,0.0106654535274582,0,"0"
"371830525072006","3","5","2","10","3","5","3","11","4","14","15",0,0.00234621059908955,0,"0"
"371830540132049","2","4","1","7","2","5","2","9","4","11","13",0,0.000895120378577342,0,"0"
"371830540132032","1","4","1","6","1","5","2","8","5","11","13",0,0.00299519815838799,0,"0"
"371830540132053","1","4","1","6","1","5","2","8","4","10","12",126,0.0138730343901196,9082.36773994715,"44"
"371830527012009","2","3","4","9","2","3","4","9","2","11","11",0,0.000855900480721138,0,"0"
"371830537122008","3","2","2","7","3","2","2","7","3","10","10",0,0.00335812341176907,0,"0"
"371830526021019","3","3","4","10","3","3","4","10","3","13","13",67,0.0209691129883073,3195.17568708606,"36"
"371830541052031","1","3","2","6","1","3","3","7","3","9","10",37,0.00500775965163778,7388.53351076848,"13"
"371830537111002","4","1","2","7","4","1","2","7","3","10","10",100,0.039785712524497,2513.46510228836,"35"
"371830540123006","3","4","4","11","3","4","4","11","2","13","13",34,0.00787429518648734,4317.84676530105,"19"
"371830540142002","5","3","2","10","5","4","2","11","3","13","14",76,0.00410739992742002,18503.1896924967,"25"
"371830506002002","5","4","5","14","5","5","5","15","3","17","18",28,0.00558145933542254,5016.60915493892,"14"
"371830506002003","5","4","5","14","5","5","5","15","3","17","18",30,0.00591586555476124,5071.10915931063,"14"
"371830507003000","4","4","5","13","4","4","5","13","3","16","16",33,0.00704314038530099,4685.4099442446,"13"
"371830520012019","3","4","5","12","5","5","5","15","3","15","18",0,0.00697816063399854,0,"0"
"371830519001030","3","4","4","11","5","4","5","14","4","15","18",0,0.0017489704428241,0,"0"
"371830541062031","4","5","4","13","4","5","5","14","3","16","17",0,0.00363102283973713,0,"0"
"371830541131020","1","1","1","3","4","3","2","9","4","7","13",62,0.0074663801193198,8303.89010593908,"31"
"371830541063015","3","3","2","8","3","3","2","8","4","12","12",0,0.000693643436225887,0,"0"
"371830528063003","5","1","2","8","5","2","2","9","4","12","13",201,0.0182282995713554,11026.8102196356,"56"
"371830537241047","3","5","2","10","3","5","2","10","2","12","12",0,0.0291160024179634,0,"0"
"371830537113019","3","5","3","11","3","5","3","11","5","16","16",15,0.00391772173783778,3828.75584427765,"12"
"371830524011096","1","5","2","8","2","5","3","10","3","11","13",2,0.0190037779812979,105.242231411472,"1"
"371830525043011","5","3","4","12","5","3","4","12","5","17","17",14,0.00398918254082059,3509.49094375615,"8"
"371830525032005","3","5","3","11","3","5","3","11","5","16","16",11,0.0214911665234583,511.838200499408,"6"
"371830525041014","3","5","4","12","3","5","5","13","5","17","18",0,0.000182606689176214,0,"0"
"371830524012004","3","5","4","12","3","5","4","12","4","16","16",0,0.00551422365996155,0,"0"
"371830525042010","3","5","4","12","3","5","4","12","4","16","16",81,0.0199292941979498,4064.36872251766,"33"
"371830524011073","2","5","3","10","3","5","4","12","3","13","15",9,0.00605690897778189,1485.90643065861,"6"
"371830540083007","2","2","3","7","3","3","3","9","2","9","11",37,0.00343350325145975,10776.1657089649,"13"
"371830503002018","4","5","5","14","4","5","5","14","4","18","18",2,0.00532422386803735,375.641605156106,"2"
"371830526031000","2","3","4","9","2","3","5","10","3","12","13",0,0.00253894899275412,0,"0"
"371830512002014","4","5","5","14","5","5","5","15","4","18","19",75,0.00897474419105305,8356.78414932069,"38"
"371830510001022","4","5","5","14","5","5","5","15","4","18","19",46,0.00715387597274523,6430.08072480573,"37"
"371830501001081","5","5","5","15","5","5","5","15","5","20","20",97,0.00857608906831834,11310.5168599911,"74"
"371830501001080","5","5","5","15","5","5","5","15","5","20","20",0,0.00852952934223937,0,"0"
"371830514005023","5","5","5","15","5","5","5","15","4","19","19",38,0.00641654259116291,5922.19243620933,"26"
"371830517003007","3","2","4","9","3","3","4","10","5","14","15",48,0.0209701616201569,2288.96662169077,"18"
"371830506003017","5","5","5","15","5","5","5","15","5","20","20",28,0.00400516786510774,6990.96790522332,"15"
"371830507001015","5","5","5","15","5","5","5","15","5","20","20",55,0.00522227664850805,10531.8051305675,"26"
"371830506002011","5","4","5","14","5","5","5","15","4","18","19",16,0.00385167699893631,4154.03472420418,"5"
"371830508001015","5","5","5","15","5","5","5","15","5","20","20",4,0.00109398425936056,3656.35973806244,"3"
"371830508002001","5","5","5","15","5","5","5","15","5","20","20",59,0.0112241115894152,5256.54075424902,"16"
"371830541062033","3","2","4","9","4","3","5","12","3","12","15",0,0.000367316343548004,0,"0"
"371830528064003","1","1","1","3","1","2","1","4","5","8","9",65,0.0186030815908184,3494.04477331761,"18"
"371830527051030","3","3","4","10","3","4","4","11","3","13","14",0,0.00245258484362092,0,"0"
"371830541055012","2","3","2","7","2","3","3","8","3","10","11",7,0.00669381178458514,1045.74198158962,"5"
"371830512001008","4","5","5","14","5","5","5","15","3","17","18",91,0.0110059999455925,8268.21737687198,"64"
"371830507003037","5","5","5","15","5","5","5","15","4","19","19",18,0.0107473376587856,1674.83339329956,"9"
"371830507003009","5","5","5","15","5","5","5","15","4","19","19",18,0.00238312844033279,7553.09688532207,"5"
"371830507003033","5","5","5","15","5","5","5","15","4","19","19",26,0.00352590334702567,7373.99680054551,"12"
"371830504002001","5","4","5","14","5","4","5","14","3","17","17",64,0.00506891027218341,12625.9879468003,"40"
"371830516001022","3","4","5","12","5","4","5","14","3","15","17",22,0.0118643120168531,1854.30052486392,"10"
"371830541051012","5","3","2","10","5","4","3","12","5","15","17",0,0.0196094591875454,0,"0"
"371830541061024","1","3","4","8","2","3","4","9","4","12","13",0,0.00138182895214242,0,"0"
"371830527061020","5","3","4","12","5","3","4","12","3","15","15",63,0.0107365083414106,5867.8294652843,"34"
"371830541063040","3","3","2","8","3","3","2","8","4","12","12",0,0.00463451413219331,0,"0"
"371830526012006","4","3","4","11","4","3","4","11","4","15","15",28,0.00895040176183374,3128.35118970832,"13"
"371830526012010","3","4","4","11","3","4","5","12","4","15","16",362,0.0270833051384932,13366.1677608725,"288"
"371830545001019","5","5","5","15","5","5","5","15","5","20","20",53,0.00957514367484445,5535.16498548634,"17"
"371830545002051","2","2","3","7","2","2","3","7","3","10","10",0,0.00305479442303725,0,"0"
"371830528064049","1","1","1","3","1","2","1","4","4","7","8",70,0.00738945841056507,9472.95405302201,"23"
"371830528072015","3","1","1","5","3","3","2","8","2","7","10",32,0.00416944300570565,7674.88605941125,"8"
"371830528064053","1","1","1","3","1","2","1","4","4","7","8",0,0.00663994638854685,0,"0"
"371830527073029","3","3","3","9","3","4","4","11","2","11","13",9,0.00598670516950644,1503.33108866659,"3"
"371830541062042","3","2","2","7","3","2","2","7","4","11","11",32,0.0210697791349979,1518.76295403811,"13"
"371830523022011","2","5","3","10","3","5","3","11","3","13","14",138,0.00456034075693343,30260.8965766841,"57"
"371830538082005","1","1","2","4","5","1","3","9","4","8","13",41,0.014185961543534,2890.18124532334,"14"
"371839801001001","1","5","1","7","1","5","1","7","1","8","8",0,0.00426629408566904,0,"0"
"371830536101087","2","5","1","8","2","5","1","8","1","9","9",39,0.00231737835230786,16829.3623530056,"24"
"371830537112021","3","1","2","6","3","1","2","6","4","10","10",9,0.00784550215046817,1147.15410529369,"5"
"371830537252045","1","5","2","8","1","5","2","8","3","11","11",0,0.000235656793973549,0,"0"
"371830542071042","2","4","1","7","2","5","1","8","3","10","11",26,0.00686526232626234,3787.18230482464,"13"
"371830542071090","4","5","1","10","4","5","1","10","3","13","13",76,0.0157564814593257,4823.41188901779,"23"
"371830503002008","4","5","5","14","5","5","5","15","3","17","18",2,0.00848974103751344,235.578445934057,"2"
"371830508003001","5","5","5","15","5","5","5","15","4","19","19",21,0.00297233237965275,7065.15870962366,"5"
"371830507003034","5","5","5","15","5","5","5","15","4","19","19",26,0.00312452470256421,8321.26562438841,"9"
"371830516001021","3","4","5","12","4","4","5","13","3","15","16",71,0.0108033704612025,6572.02307881398,"30"
"371830516005016","4","4","5","13","5","4","5","14","3","16","17",36,0.0065978993918916,5456.28204701662,"15"
"371830516005006","4","4","5","13","5","5","5","15","3","16","18",54,0.0141388633067558,3819.26034847497,"19"
"371830527012028","2","2","4","8","2","3","4","9","3","11","12",0,0.0600812586774707,0,"0"
"371830542071108","2","4","1","7","2","5","1","8","3","10","11",134,0.0317154444240429,4225.07085848739,"112"
"371830542091047","3","2","1","6","3","2","1","6","3","9","9",56,0.0144412758692404,3877.77371660621,"19"
"371830537211029","3","5","2","10","3","5","2","10","2","12","12",15,0.0333570958596495,449.679434418174,"5"
"371830540131044","4","5","3","12","4","5","3","12","5","17","17",93,0.0136428437955926,6816.76059576701,"60"
"371830540043013","2","3","3","8","2","3","3","8","2","10","10",41,0.00320033911792683,12811.1423474896,"30"
"371830540162022","2","4","2","8","2","4","3","9","2","10","11",0,0.00150480126531149,0,"0"
"371830540151021","3","3","2","8","3","3","3","9","3","11","12",0,0.00045094615869534,0,"0"
"371830540131014","1","5","2","8","1","5","2","8","3","11","11",14,0.00207438585394287,6748.9854760577,"6"
"371830526011023","4","4","4","12","4","4","5","13","4","16","17",17,0.00467124148297413,3639.28948267009,"7"
"371830501001047","4","5","5","14","4","5","5","14","4","18","18",43,0.00877050833800505,4902.79449523684,"24"
"371830526012020","5","3","4","12","5","3","5","13","5","17","18",26,0.00984958002843324,2639.70645702097,"14"
"371830503002015","4","5","5","14","5","5","5","15","4","18","19",43,0.0085520740889912,5028.02005134082,"28"
"371830501001032","4","5","5","14","5","5","5","15","3","17","18",0,0.0018564131406296,0,"0"
"371830501001083","5","5","5","15","5","5","5","15","5","20","20",0,0.00471852689437642,0,"0"
"371830537171002","1","1","1","3","1","1","1","3","2","5","5",0,0.029976265134848,0,"0"
"371830537262001","2","5","2","9","2","5","2","9","4","13","13",24,0.0151458393126728,1584.59359726065,"11"
"371830540081004","4","4","3","11","4","4","3","11","2","13","13",83,0.01330679219989,6237.41610699282,"28"
"371830541042012","2","2","1","5","2","2","2","6","3","8","9",6,0.0216629617699532,276.97043754756,"1"
"371830540134029","1","2","1","4","1","3","2","6","3","7","9",2,0.00495213377997593,403.866310738019,"1"
"371830540131012","2","5","2","9","2","5","2","9","3","12","12",3,0.00168073911059314,1784.92901194005,"1"
"371830541042033","3","2","2","7","3","2","2","7","3","10","10",0,0.000352890466272311,0,"0"
"371830540082006","4","3","3","10","4","3","3","10","2","12","12",0,0.00139557106232631,0,"0"
"371830540134023","1","4","1","6","1","4","1","6","5","11","11",120,0.00572676846058895,20954.2258999692,"53"
"371830516001005","3","4","4","11","5","4","5","14","3","14","17",94,0.0196978668606137,4772.09033166708,"38"
"371830511021001","5","5","5","15","5","5","5","15","4","19","19",0,0.00834644749140231,0,"0"
"371830512003018","5","5","5","15","5","5","5","15","4","19","19",235,0.00645259820741067,36419.4379451843,"6"
"371830510002002","4","5","5","14","5","5","5","15","5","19","20",37,0.0116099683843352,3186.91651649305,"28"
"371830528062054","4","1","2","7","4","2","2","8","3","10","11",50,0.0138889264430879,3599.99026597794,"21"
"371830541061043","2","2","2","6","2","2","2","6","3","9","9",31,0.00331831379823199,9342.09417340727,"9"
"371830536101084","1","5","1","7","1","5","1","7","1","8","8",0,0.00387981435147266,0,"0"
"371830525051017","5","5","3","13","5","5","4","14","5","18","19",72,0.0514256375475061,1400.07987131881,"31"
"371830537232008","3","2","3","8","3","2","3","8","4","12","12",1,0.000325423697942723,3072.91695817434,"1"
"371830537262018","3","5","2","10","3","5","3","11","4","14","15",0,0.000615641896993782,0,"0"
"371830537241018","4","5","2","11","4","5","2","11","2","13","13",0,0.00143312176820133,0,"0"
"371830537241011","1","5","1","7","1","5","1","7","1","8","8",0,0.013354448148511,0,"0"
"371830514005019","5","5","5","15","5","5","5","15","3","18","18",37,0.00416906602468974,8874.88943108152,"13"
"371830537111029","1","5","1","7","1","5","1","7","2","9","9",48,0.0272972665600985,1758.4178215911,"15"
"371830540131008","2","5","2","9","2","5","2","9","3","12","12",4,0.00340327879752627,1175.33714925367,"2"
"371830540141051","3","3","2","8","3","4","2","9","4","12","13",71,0.00586836143168911,12098.7776275334,"23"
"371830540182014","1","4","2","7","1","4","3","8","2","9","10",0,0.00255001013948981,0,"0"
"371830526012019","4","3","4","11","4","4","5","13","4","15","17",74,0.0187929492925328,3937.64697856142,"30"
"371830524011000","5","5","3","13","5","5","3","13","5","18","18",6,0.027933803015417,214.793524415151,"2"
"371830536101017","2","5","1","8","2","5","1","8","1","9","9",6,0.000598980383465541,10017.0225363402,"2"
"371830537142022","3","3","3","9","3","3","3","9","4","13","13",2,0.00498202028410087,401.443568261374,"1"
"371830537232007","2","1","3","6","3","2","3","8","4","10","12",2,0.000343181477128251,5827.82036121541,"1"
"371830540072014","3","1","2","6","3","1","3","7","4","10","11",0,0.000213852423650908,0,"0"
"371830525052014","3","3","4","10","3","4","4","11","5","15","16",0,0.00302492956483713,0,"0"
"371830537092001","1","5","2","8","1","5","2","8","3","11","11",0,0.000186244692557981,0,"0"
"371830508001016","5","5","5","15","5","5","5","15","5","20","20",34,0.00198567017351461,17122.6825348443,"10"
"371830508001020","5","5","5","15","5","5","5","15","4","19","19",4,0.00130639806614431,3061.85388945465,"2"
"371830512002003","5","5","5","15","5","5","5","15","3","18","18",0,0.0160723911684745,0,"0"
"371830501001078","5","5","5","15","5","5","5","15","5","20","20",472,0.0084333612774327,55968.1939943746,"312"
"371830501001088","5","5","5","15","5","5","5","15","5","20","20",536,0.00841522038870858,63694.113195086,"0"
"371830510002003","5","5","5","15","5","5","5","15","5","20","20",53,0.00471648363254721,11237.1851847976,"30"
"371830526012002","3","4","4","11","3","4","4","11","4","15","15",45,0.0114053566117599,3945.51450969987,"18"
"371830545001020","5","5","5","15","5","5","5","15","5","20","20",14,0.0054108689618309,2587.38478029281,"5"
"371830527072010","3","4","4","11","3","4","4","11","2","13","13",5,0.00566690140505108,882.316391730999,"4"
"371830542071027","1","2","1","4","1","2","1","4","2","6","6",28,0.00379825948137841,7371.79756603639,"12"
"371830542081116","2","4","1","7","2","5","1","8","3","10","11",36,0.00217382334235383,16560.6833354816,"12"
"371830541061004","2","1","1","4","2","1","2","5","3","7","8",92,0.00898581614988007,10238.35770346,"28"
"371830528063013","3","1","1","5","3","1","2","6","3","8","9",37,0.00731887892860442,5055.41905542291,"14"
"371830527061021","5","3","4","12","5","3","4","12","3","15","15",9,0.00239067332010163,3764.62979041294,"4"
"371830530081055","3","4","2","9","3","4","2","9","3","12","12",8,0.00802270222659649,997.170251873336,"4"
"371830537241053","2","5","2","9","2","5","2","9","2","11","11",65,0.00381235446780975,17049.8311604648,"34"
"371830545003017","1","2","3","6","1","2","3","6","3","9","9",44,0.0083768927074923,5252.54429493246,"20"
"371830540134045","2","5","2","9","2","5","2","9","5","14","14",37,0.00501860446002584,7372.56747263352,"12"
"371830540162013","2","4","2","8","2","4","3","9","2","10","11",38,0.00275357295723967,13800.2517420469,"18"
"371830541062013","2","2","3","7","2","2","4","8","3","10","11",0,0.0941319432681309,0,"0"
"371830507001003","5","5","5","15","5","5","5","15","5","20","20",51,0.0191940962767659,2657.06700980418,"19"
"371830530081017","2","4","2","8","2","4","2","8","3","11","11",61,0.00335673226294789,18172.4353393707,"39"
"371830528064045","1","1","1","3","2","2","1","5","4","7","9",102,0.0127053229759762,8028.13121656698,"43"
"371830541103042","1","1","1","3","5","3","2","10","3","6","13",0,0.0173300060264416,0,"0"
"371830541051044","2","1","1","4","2","1","2","5","3","7","8",0,0.000361595113585538,0,"0"
"371830535211003","3","5","2","10","3","5","2","10","4","14","14",20,0.030639856212679,652.744577558554,"7"
"371830536101032","1","1","1","3","1","1","1","3","1","4","4",0,0.000139642925165859,0,"0"
"371830501001082","5","5","5","15","5","5","5","15","5","20","20",0,0.00485388401591276,0,"0"
"371830538082021","2","3","3","8","2","3","3","8","5","13","13",9,0.00403622372241868,2229.80702234385,"3"
"371830538084015","2","4","3","9","2","4","3","9","3","12","12",0,0.00270665592773945,0,"0"
"371830536101086","2","5","1","8","2","5","1","8","1","9","9",59,0.00218289801895611,27028.2896808045,"24"
"371830537171035","1","1","1","3","5","1","2","8","1","4","9",9,0.00196418882550618,4582.04419204995,"3"
"371830537171027","1","5","1","7","2","5","1","8","1","8","9",0,0.0247384724334457,0,"0"
"371830537142020","4","3","3","10","4","3","3","10","5","15","15",44,0.0177510028290702,2478.73319742493,"17"
"371830537151013","5","5","4","14","5","5","4","14","5","19","19",77,0.0214011341869649,3597.94015248498,"31"
"371830540062007","4","4","4","12","4","4","4","12","4","16","16",0,0.0185133521731803,0,"0"
"371830540012017","4","2","3","9","4","2","4","10","3","12","13",108,0.0236920767303307,4558.48599636426,"41"
"371830540071007","2","2","3","7","2","2","3","7","5","12","12",34,0.00468425922901817,7258.35149971546,"22"
"371830537241031","3","5","2","10","3","5","2","10","3","13","13",36,0.00489054724507868,7361.13939727839,"10"
"371830524011059","1","5","3","9","1","5","3","9","5","14","14",0,0.0213758129645138,0,"0"
"371830540143026","1","3","2","6","2","4","3","9","2","8","11",0,0.00929316556162624,0,"0"
"371830515011038","3","3","4","10","4","3","5","12","4","14","16",0,0.00127235436557855,0,"0"
"371830509001025","4","5","5","14","4","5","5","14","5","19","19",0,0.0108073466551379,0,"0"
"371830524041021","3","5","3","11","3","5","4","12","4","15","16",0,0.00791581824974986,0,"0"
"371830501001072","5","5","5","15","5","5","5","15","5","20","20",287,0.00506822735467464,56627.2939068702,"0"
"371830542091044","2","1","1","4","2","1","1","4","3","7","7",0,0.00242799141307593,0,"0"
"371830536101030","1","1","1","3","1","1","1","3","1","4","4",30,0.00201558984924874,14883.9804939391,"12"
"371830537121009","2","1","2","5","2","1","2","5","3","8","8",61,0.0301106557904731,2025.86089205338,"23"
"371830537251014","3","5","2","10","3","5","2","10","4","14","14",29,0.00473038136238764,6130.58393781646,"13"
"371830537262010","1","5","2","8","1","5","2","8","3","11","11",0,0.00311198214988803,0,"0"
"371830537241079","1","5","2","8","1","5","2","8","3","11","11",20,0.00178068338841835,11231.6429355611,"10"
"371830541062054","4","2","2","8","4","3","2","9","5","13","14",43,0.01726685672673,2490.32007854873,"13"
"371830537132020","4","2","2","8","4","2","3","9","4","12","13",0,0.00365840719347411,0,"0"
"371830537112002","1","5","1","7","1","5","1","7","2","9","9",81,0.0311093654961874,2603.7175206909,"27"
"371830537211030","4","5","2","11","4","5","2","11","2","13","13",44,0.0303016350990287,1452.06685567309,"18"
"371830540141013","2","2","1","5","3","3","2","8","4","9","12",12,0.0493745575259299,243.04015268791,"6"
"371830540162024","2","4","2","8","3","4","3","10","2","10","12",0,0.00287986264955719,0,"0"
"371830540181022","3","4","4","11","3","4","4","11","2","13","13",23,0.00151591000450398,15172.4046491307,"21"
"371830540134016","2","5","2","9","2","5","2","9","5","14","14",64,0.00887901391425188,7208.00762540448,"25"
"371830509003013","5","5","5","15","5","5","5","15","5","20","20",71,0.0161203056252975,4404.38299684468,"31"
"371830515022020","5","4","4","13","5","4","5","14","4","17","18",0,0.00198626674652231,0,"0"
"371830514001005","5","5","5","15","5","5","5","15","4","19","19",21,0.00605349318844847,3469.0713851092,"13"
"371830514001008","4","5","5","14","5","5","5","15","3","17","18",74,0.0145020601793354,5102.72327413492,"27"
"371830537241054","2","5","2","9","2","5","2","9","2","11","11",54,0.00513156778474424,10523.0998137719,"15"
"371830527013002","5","3","4","12","5","3","5","13","3","15","16",9,0.00280140573370798,3212.67279912627,"3"
"371830540181024","2","3","4","9","2","4","4","10","2","11","12",0,0.0370799894571391,0,"0"
"371830540181012","2","3","3","8","2","3","3","8","2","10","10",0,0.00512227071365096,0,"0"
"371830527041004","4","2","4","10","4","3","4","11","3","13","14",0,0.0537692735719378,0,"0"
"371830540181014","3","3","4","10","3","4","4","11","2","12","13",2,0.0236285033440415,84.6435328924185,"1"
"371830540141020","2","2","1","5","2","3","2","7","5","10","12",134,0.0134241668032318,9981.99753952253,"44"
"371830512001004","4","5","5","14","5","5","5","15","3","17","18",60,0.0181478882493609,3306.16979648379,"27"
"371830516005001","3","4","5","12","5","4","5","14","3","15","17",30,0.00860684341550707,3485.59844204306,"14"
"371830517002018","4","4","5","13","4","4","5","13","3","16","16",86,0.0179194897766458,4799.24378829593,"42"
"371830518002018","5","4","5","14","5","4","5","14","3","17","17",47,0.00721257977045837,6516.39239991561,"20"
"371830527063027","1","2","3","6","1","3","4","8","3","9","11",0,0.00342065343834576,0,"0"
"371830542081091","1","4","1","6","1","5","1","7","2","8","9",0,0.0312601630601648,0,"0"
"371830542071056","1","2","1","4","1","2","1","4","2","6","6",4,0.00462702466774558,864.486422102633,"1"
"371830542091043","3","2","1","6","3","2","1","6","3","9","9",53,0.00820555878105281,6459.03605277688,"18"
"371830542091078","2","1","1","4","2","2","1","5","3","7","8",2,0.00369406771073939,541.408592534891,"1"
"371830542091072","2","1","1","4","2","2","1","5","3","7","8",77,0.00619708875313611,12425.1891601574,"19"
"371830541102031","1","1","1","3","1","2","1","4","3","6","7",12,0.00134872864795232,8897.26782197351,"4"
"371830542071031","1","2","1","4","1","2","1","4","2","6","6",99,0.0101933660270983,9712.19906523673,"30"
"371830542091054","2","1","1","4","2","1","1","4","3","7","7",0,0.00522741624945595,0,"0"
"371830542071096","2","4","1","7","2","5","1","8","3","10","11",33,0.00483604285950286,6823.76086373071,"9"
"371830542071098","2","4","1","7","2","5","1","8","2","9","10",21,0.00205440932436785,10221.9162222999,"6"
"371830542071060","1","2","1","4","1","2","1","4","2","6","6",0,0.00708408519043382,0,"0"
"371830542081124","2","4","1","7","2","5","1","8","3","10","11",50,0.00772166670108533,6475.28596293494,"29"
"371830524063006","1","5","2","8","3","5","2","10","2","10","12",72,0.00619396681930234,11624.2146754202,"43"
"371830519002000","3","3","4","10","3","3","5","11","5","15","16",345,0.0550941511808522,6262.0077196126,"140"
"371830523011012","3","5","3","11","3","5","3","11","3","14","14",18,0.0115583839665274,1557.31113035587,"5"
"371830523023024","2","4","3","9","2","4","3","9","2","11","11",8,0.00480077930917025,1666.39611713014,"2"
"371830545003005","2","2","3","7","2","2","3","7","3","10","10",0,0.00578200808091269,0,"0"
"371830511021013","5","5","5","15","5","5","5","15","4","19","19",0,0.00773539532573086,0,"0"
"371830521011006","3","3","4","10","3","3","4","10","3","13","13",0,0.0137576224580771,0,"0"
"371830511022010","5","5","5","15","5","5","5","15","5","20","20",402,0.0100750207618846,39900.6621922635,"0"
"371830521021046","3","3","4","10","3","4","4","11","4","14","15",6,0.00913412040465483,656.877699678925,"4"
"371830528033011","1","2","3","6","2","3","4","9","3","9","12",42,0.0328324820575118,1279.22098385464,"12"
"371830528072037","1","1","1","3","1","1","2","4","3","6","7",0,0.039818929882639,0,"0"
"371830530031015","2","4","2","8","2","4","2","8","3","11","11",0,0.0189836952705417,0,"0"
"371830536101001","1","1","1","3","1","1","1","3","1","4","4",0,0.129826314478815,0,"0"
"371830540141067","2","3","1","6","2","4","2","8","4","10","12",16,0.00786573989603698,2034.13794652189,"8"
"371830541044004","2","2","3","7","5","3","4","12","2","9","14",59,0.00532917589279198,11071.1301685127,"16"
"371830542091080","3","1","1","5","3","1","1","5","3","8","8",58,0.00574801746040317,10090.4355979343,"23"
"371830527073044","2","3","3","8","2","3","4","9","3","11","12",3,0.000629987531632506,4761.99900691052,"1"
"371830523012000","4","5","4","13","4","5","4","13","4","17","17",909,0.128526194200815,7072.48826320756,"367"
"371830516005009","4","4","5","13","5","4","5","14","3","16","17",0,0.00110847817392452,0,"0"
"371830524093007","4","5","4","13","4","5","5","14","4","17","18",231,0.0163125287687256,14160.8945660757,"95"
"371830536101011","1","5","1","7","1","5","1","7","1","8","8",764,0.242621461926413,3148.93824286543,"338"
"371830536101093","1","5","1","7","1","5","1","7","1","8","8",0,0.00106280919548918,0,"0"
"371830537252011","3","5","2","10","3","5","2","10","3","13","13",48,0.027744660891393,1730.06259430947,"17"
"371830527072004","3","3","3","9","3","3","4","10","2","11","12",81,0.0227814484860441,3555.52457736041,"34"
"371830527073018","3","3","3","9","3","3","3","9","2","11","11",343,0.0362383536713549,9465.10989739384,"97"
"371830541043039","1","3","3","7","5","4","3","12","2","9","14",46,0.00280867484722019,16377.8302944277,"17"
"371830526011003","3","4","3","10","4","4","4","12","4","14","16",106,0.0466888168086614,2270.35095865474,"48"
"371830528064010","1","1","1","3","1","1","1","3","4","7","7",47,0.00413469583254281,11367.2206864841,"13"
"371830528064009","1","1","1","3","1","2","1","4","4","7","8",616,0.180899386333357,3405.2077924955,"201"
"371830528072012","3","1","2","6","3","3","2","8","3","9","11",17,0.00335624102541472,5065.19045303052,"7"
"371830511023004","4","5","5","14","5","5","5","15","5","19","20",868,0.0899198316687339,9653.04298163864,"0"
"371830512002020","5","5","5","15","5","5","5","15","4","19","19",61,0.00600999888836681,10149.7522933114,"28"
"371830541061041","1","2","2","5","1","3","3","7","2","7","9",0,0.0519567304305552,0,"0"
"371830541051041","3","3","2","8","3","3","2","8","3","11","11",0,0.000327704727468863,0,"0"
"371830540151049","4","4","3","11","4","4","3","11","2","13","13",0,0.00588932691073564,0,"0"
"371830541103005","1","1","1","3","2","2","1","5","3","6","8",148,0.0351023651462923,4216.24011325723,"40"
"371830528072033","1","1","1","3","1","1","2","4","3","6","7",0,0.00477920525752803,0,"0"
"371830506003010","5","5","5","15","5","5","5","15","4","19","19",45,0.00581864301787104,7733.76195477014,"20"
"371830527061009","2","2","3","7","2","2","4","8","3","10","11",241,0.0143989354100737,16737.3485008754,"52"
"371830524011056","1","5","3","9","1","5","3","9","3","12","12",0,0.0927776526856227,0,"0"
"371830527043008","5","3","4","12","5","3","4","12","2","14","14",48,0.0102174445601709,4697.84785396451,"15"
"371830521011003","4","4","5","13","4","4","5","13","3","16","16",40,0.00661052133622516,6050.95997206802,"17"
"371830525032021","4","5","3","12","4","5","3","12","4","16","16",163,0.0384405688973059,4240.31185478693,"141"
"371830525031014","2","5","2","9","2","5","2","9","3","12","12",184,0.00194524568527161,94589.5942055814,"80"
"371830525033003","1","5","1","7","1","5","1","7","5","12","12",30,0.00922901724011256,3250.61696380948,"9"
"371830524011068","2","3","3","8","2","3","4","9","3","11","12",103,0.075126913207786,1371.0133373259,"61"
"371830516002002","2","4","4","10","3","4","5","12","3","13","15",90,0.0372988423029136,2412.94352433479,"47"
"371830541061034","1","2","3","6","2","3","4","9","4","10","13",3,0.0301779363082903,99.410376155372,"1"
"371830525033000","1","1","1","3","1","1","1","3","5","8","8",137,0.4129393808696,331.76782439954,"42"
"371830537131015","4","5","3","12","4","5","3","12","5","17","17",15,0.00437209590774125,3430.84880032959,"13"
"371830528033037","3","2","4","9","3","2","4","9","3","12","12",97,0.115776133915892,837.82379596876,"33"
"371830536101049","1","5","1","7","1","5","1","7","1","8","8",89,0.00337641502154427,26359.3188136256,"45"
"371830536101043","3","1","1","5","3","1","1","5","1","6","6",79,0.0140970398833076,5604.01337117196,"21"
"371830537111034","4","1","2","7","4","1","2","7","4","11","11",37,0.0169614419927081,2181.41830251854,"14"
"371830537252037","1","5","2","8","1","5","2","8","3","11","11",46,0.00223026955537654,20625.3095681224,"24"
"371830537261005","4","2","3","9","4","2","3","9","5","14","14",322,0.0284745628405928,11308.3386671336,"175"
"371830537241032","2","5","1","8","2","5","1","8","2","10","10",0,0.000443026423271005,0,"0"
"371830537252034","1","5","2","8","1","5","2","8","3","11","11",0,0.00199369946899378,0,"0"
"371830538071008","5","2","3","10","5","2","3","10","2","12","12",434,0.255631605479074,1697.75564013945,"134"
"371830538084002","5","5","3","13","5","5","3","13","4","17","17",0,0.168631984919702,0,"0"
"371830538082001","1","1","1","3","1","1","1","3","2","5","5",0,0.00629056400403484,0,"0"
"371830540171058","2","4","3","9","2","4","3","9","2","11","11",65,0.0149205243516073,4356.41526184018,"26"
"371830528072028","4","2","1","7","4","4","2","10","2","9","12",2,0.000745536094047524,2682.63336405616,"1"
"371830521021030","4","3","4","11","4","4","5","13","3","14","16",436,0.0546474237341573,7978.41819810216,"128"
"371830541062039","4","2","2","8","4","3","2","9","5","13","14",36,0.0176890745225994,2035.15452173638,"14"
"371830541051042","3","3","2","8","3","3","2","8","3","11","11",0,0.00512989543492455,0,"0"
"371830511012010","4","4","4","12","4","4","4","12","4","16","16",76,0.0580449387977837,1309.33034945162,"31"
"371830517003008","3","2","3","8","3","2","4","9","4","12","13",0,0.0107271205195948,0,"0"
"371830524071023","4","5","3","12","4","5","4","13","3","15","16",0,0.0110351550740833,0,"0"
"371830527013020","5","4","5","14","5","4","5","14","5","19","19",0,0.00592260302716626,0,"0"
"371830524062017","1","5","2","8","2","5","3","10","3","11","13",0,0.00580163580866917,0,"0"
"371830535161000","1","2","1","4","2","2","1","5","2","6","7",0,0.0145838922272226,0,"0"
"371830530031003","1","3","2","6","2","4","2","8","3","9","11",0,0.0180619025673693,0,"0"
"371830536101028","1","1","1","3","1","1","1","3","1","4","4",40,0.00333109393152534,12008.067266264,"20"
"371830536101026","1","1","1","3","1","1","1","3","1","4","4",41,0.0038438632163538,10666.3524928683,"18"
"371830517003014","4","3","4","11","4","4","5","13","5","16","18",0,0.00459502833222753,0,"0"
"371830519002015","4","4","5","13","5","4","5","14","4","17","18",330,0.0407573266248595,8096.70376659886,"118"
"371830528072083","4","2","1","7","4","4","2","10","2","9","12",56,0.00525517300951733,10656.1667710239,"18"
"371830541041026","2","3","2","7","3","4","3","10","3","10","13",49,0.0818266102922141,598.827200894846,"16"
"371830527041008","5","3","4","12","5","3","4","12","2","14","14",1905,0.0879323005864149,21664.3939405165,"516"
"371830511011002","3","5","5","13","3","5","5","13","5","18","18",0,0.0397807335401766,0,"0"
"371830521012005","5","4","5","14","5","4","5","14","3","17","17",143,0.0280197042718847,5103.55136558268,"50"
"371830519003017","4","4","4","12","5","4","5","14","4","16","18",105,0.0217466504523352,4828.32978026393,"53"
"371830501001062","5","5","5","15","5","5","5","15","5","20","20",6,0.00500893751467413,1197.85882383689,"5"
"371830537113002","5","5","3","13","5","5","3","13","5","18","18",280,0.0669457018471742,4182.49405524485,"121"
"371830521011029","2","2","3","7","2","2","4","8","2","9","10",53,0.00661053041784908,8017.51094842477,"16"
"371830537251001","3","5","2","10","3","5","2","10","3","13","13",310,0.169732741039064,1826.40071739991,"106"
"371830528062053","4","1","2","7","4","2","2","8","3","10","11",1,0.000715919767770036,1396.80456528645,"1"
"371830537251011","2","5","2","9","2","5","2","9","4","13","13",496,0.116186850972943,4268.98565411249,"233"
"371830540043010","3","4","4","11","3","4","4","11","2","13","13",0,0.00111250251252471,0,"0"
"371830525072024","1","1","2","4","1","1","2","4","5","9","9",119,0.0795013758153721,1496.82944200056,"43"
"371830525072018","2","5","2","9","2","5","2","9","4","13","13",0,0.00119552864818163,0,"0"
"371830514002008","5","5","5","15","5","5","5","15","4","19","19",78,0.0120364826051827,6480.29848573989,"35"
"371830537163001","3","3","3","9","3","3","3","9","4","13","13",1142,0.190212083857493,6003.8246616108,"559"
"371830537142011","5","3","3","11","5","3","3","11","5","16","16",23,0.0107630123650438,2136.94820928568,"7"
"371830515021002","4","5","4","13","4","5","5","14","5","18","19",19,0.00217463231695396,8737.10918938866,"6"
"371830541051029","4","2","2","8","4","2","2","8","4","12","12",47,0.00222653149617453,21109.0658635425,"14"
"371830537092021","2","5","2","9","2","5","2","9","3","12","12",369,0.0313552747272787,11768.3548688213,"237"
"371830521011009","2","3","4","9","2","3","4","9","3","12","12",120,0.0211796610218573,5665.81305886628,"38"
"371830537132004","4","3","3","10","4","3","3","10","4","14","14",101,0.0066732452718622,15135.064857554,"54"
"371830537112007","4","5","2","11","4","5","2","11","3","14","14",0,0.00421914960987509,0,"0"
"371830537181010","1","1","1","3","5","1","2","8","1","4","9",147,0.0181344850196286,8106.10281135025,"47"
"371830540122001","4","4","4","12","4","4","4","12","2","14","14",53,0.0161611188151822,3279.4759203311,"19"
"371830540181005","4","4","4","12","4","4","4","12","2","14","14",16,0.0417916304864137,382.851777108853,"5"
"371830540171057","2","4","3","9","2","4","3","9","3","12","12",26,0.00614322894765271,4232.30197369324,"12"
"371830527011017","5","3","4","12","5","3","4","12","2","14","14",69,0.0183632829390451,3757.49805898203,"21"
"371830540141077","1","3","2","6","1","3","2","6","3","9","9",118,0.0189744297023303,6218.89573764147,"31"
"371830541041041","3","3","2","8","3","3","2","8","4","12","12",106,0.00819752549223772,12930.7313652604,"26"
"371830523013025","3","5","3","11","3","5","4","12","4","15","16",146,0.0128751128872299,11339.7063993753,"67"
"371830540141074","2","2","1","5","2","3","2","7","3","8","10",110,0.0340789795753013,3227.79617731636,"34"
"371830541042022","4","3","2","9","4","3","3","10","3","12","13",382,0.0232625172378397,16421.2667139317,"89"
"371830527043014","5","3","4","12","5","3","4","12","2","14","14",125,0.0215217886671633,5808.06743961378,"36"
"371830523022015","5","5","4","14","5","5","4","14","3","17","17",69,0.0204937698350374,3366.87688772777,"22"
"371830540131037","2","5","2","9","2","5","2","9","4","13","13",160,0.028117478269651,5690.41072835818,"58"
"371830540162026","2","4","2","8","2","4","2","8","5","13","13",92,0.0142529234752734,6454.81610559444,"28"
"371830540171019","2","4","3","9","2","4","3","9","2","11","11",110,0.00793266888375006,13866.707612785,"54"
"371830506003002","5","5","5","15","5","5","5","15","4","19","19",44,0.00808077192499211,5445.02436257573,"20"
"371830525043021","3","5","3","11","3","5","4","12","4","15","16",364,0.253884047939551,1433.72536775791,"183"
"371830545003014","1","4","3","8","1","4","3","8","3","11","11",107,0.0117681445049507,9092.34246358778,"56"
"371830515012028","4","4","4","12","4","4","5","13","4","16","17",94,0.0394680030613482,2381.6761099843,"43"
"371830515022003","5","4","4","13","5","4","5","14","4","17","18",122,0.0687583956938749,1774.32877496396,"60"
"371830515011015","4","3","4","11","4","3","5","12","5","16","17",21,0.0217184299077181,966.920725357649,"11"
"371830515022010","4","5","4","13","4","5","5","14","4","17","18",170,0.044199546728766,3846.19328888639,"65"
"371830511021010","5","5","5","15","5","5","5","15","4","19","19",0,0.0204104093417202,0,"0"
"371830545002050","2","2","3","7","2","2","3","7","3","10","10",0,0.00543878829893021,0,"0"
"371830501001064","5","5","5","15","5","5","5","15","5","20","20",11,0.00833457492299529,1319.80336149487,"7"
"371830501001096","5","5","5","15","5","5","5","15","5","20","20",121,0.00862813047712924,14023.8954801086,"0"
"371830509002000","5","5","5","15","5","5","5","15","4","19","19",0,0.0178097239846269,0,"0"
"371830509002008","5","5","5","15","5","5","5","15","5","20","20",65,0.00369504709401159,17591.1154435198,"21"
"371830509002016","5","5","5","15","5","5","5","15","5","20","20",1,0.00758825394366352,131.782621855327,"0"
"371830509001001","5","5","5","15","5","5","5","15","5","20","20",275,0.00471266029392755,58353.4527948785,"0"
"371830508002005","5","5","5","15","5","5","5","15","5","20","20",93,0.0407855049824688,2280.22185921138,"31"
"371830528072070","3","1","1","5","3","2","1","6","2","7","8",45,0.00859480256317487,5235.72236467725,"19"
"371830528072017","4","1","1","6","4","3","2","9","2","8","11",106,0.0109656006537271,9666.59313495713,"31"
"371830545002005","4","4","5","13","4","4","5","13","4","17","17",0,0.00900302394166799,0,"0"
"371830528033049","1","1","2","4","2","2","2","6","3","7","9",73,0.00284996891958918,25614.3144222509,"19"
"371830528072079","1","1","1","3","4","3","1","8","3","6","11",40,0.0905670643716458,441.661660091557,"18"
"371830528072005","1","1","2","4","1","2","2","5","3","7","8",0,0.0137484602174094,0,"0"
"371830540062004","4","3","4","11","4","3","4","11","4","15","15",58,0.0137231642141346,4226.43051522048,"23"
"371830540134021","1","5","2","8","1","5","2","8","5","13","13",62,0.00794339184092796,7805.22996241327,"20"
"371830527043023","3","3","3","9","3","3","3","9","2","11","11",0,0.00524349787431612,0,"0"
"371830537073002","5","3","3","11","5","3","4","12","5","16","17",68,0.00976792916912103,6961.55744197713,"23"
"371830537162006","3","4","4","11","3","4","4","11","4","15","15",51,0.0255945031513154,1992.61535566784,"27"
"371830501001050","5","5","5","15","5","5","5","15","5","20","20",15,0.00294770270424721,5088.70856561864,"10"
"371830541062008","4","2","2","8","4","3","3","10","4","12","14",65,0.404927452247441,160.522581611187,"36"
"371830541052020","2","3","3","8","2","3","3","8","3","11","11",57,0.00657917252700853,8663.70349249942,"24"
"371830527051010","5","4","4","13","5","4","5","14","3","16","17",27,0.00685875525554711,3936.57434826288,"11"
"371830525051015","2","3","3","8","2","3","4","9","5","13","14",0,0.000723178317539679,0,"0"
"371830516001014","3","4","5","12","5","4","5","14","3","15","17",26,0.00596560114341059,4358.32020528539,"9"
"371830509001020","5","5","5","15","5","5","5","15","5","20","20",25,0.00400458652360173,6242.84176472605,"14"
"371830540071006","2","1","2","5","2","1","3","6","5","10","11",41,0.012143522388774,3376.28561856996,"14"
"371830507001006","5","5","5","15","5","5","5","15","5","20","20",72,0.0083497318222239,8623.03143777177,"29"
"371830537141012","3","3","3","9","3","3","3","9","4","13","13",74,0.01763910213511,4195.22487217224,"33"
"371830537093044","1","5","1","7","1","5","1","7","2","9","9",11,0.000772392538935562,14241.4633046031,"4"
"371830525052017","4","4","4","12","4","4","5","13","5","17","18",0,0.0041122976702846,0,"0"
"371830525052020","4","3","4","11","4","4","5","13","5","16","18",0,0.107258924986461,0,"0"
"371830537092008","2","5","2","9","2","5","2","9","3","12","12",33,0.0024952307697859,13225.2296659645,"19"
"371830525061012","2","3","3","8","2","3","3","8","4","12","12",128,0.0599550000490781,2134.93453248639,"66"
"371830526011001","2","3","4","9","4","3","4","11","3","12","14",90,0.032555765080021,2764.48732747589,"36"
"371830526011028","4","3","3","10","4","3","4","11","4","14","15",53,0.0139757738007003,3792.27660348541,"18"
"371830524063003","1","2","2","5","2","2","2","6","2","7","8",427,0.117198108330357,3643.40351634666,"158"
"371830504001004","4","4","5","13","4","4","5","13","3","16","16",0,0.0134029894440395,0,"0"
"371830524072000","2","4","3","9","3","4","4","11","3","12","14",60,0.0348074964962471,1723.76660316461,"31"
"371830524063017","1","2","2","5","5","2","3","10","2","7","12",26,0.0071837965613918,3619.25616598512,"14"
"371830524041006","4","5","4","13","4","5","4","13","3","16","16",20,0.013510852352408,1480.29150776971,"10"
"371830507002009","5","5","5","15","5","5","5","15","4","19","19",41,0.00454621315515865,9018.49486610119,"15"
"371830541061048","1","3","4","8","2","3","5","10","4","12","14",0,0.00419235755804523,0,"0"
"371830526011030","5","4","4","13","5","4","4","13","4","17","17",77,0.0197414450792644,3900.42368685955,"34"
"371830526012012","3","3","4","10","3","3","5","11","4","14","15",0,0.012079306621483,0,"0"
"371830527052000","4","4","4","12","4","4","4","12","2","14","14",68,0.0107706737269632,6313.43978323004,"21"
"371830527051015","4","2","4","10","4","3","4","11","3","13","14",41,0.00807766286144396,5075.72557845907,"15"
"371830540134039","1","4","1","6","1","4","1","6","4","10","10",46,0.00527592766427736,8718.84584609834,"27"
"371830535211001","5","5","3","13","5","5","3","13","5","18","18",1,0.00256170080196346,390.365650521533,"1"
"371830527012019","3","3","4","10","3","3","4","10","2","12","12",20,0.0424353398554271,471.305286304717,"3"
"371830540131030","2","5","2","9","2","5","2","9","3","12","12",62,0.0301819231402695,2054.20972387535,"18"
"371830540134033","1","4","1","6","1","4","1","6","5","11","11",64,0.00796712560797578,8033.0100401493,"19"
"371830541041002","1","1","1","3","4","3","2","9","5","8","14",219,0.390861806727689,560.300331806469,"99"
"371830504001027","5","5","5","15","5","5","5","15","4","19","19",0,0.00573666400571654,0,"0"
"371830540171050","2","4","3","9","2","4","3","9","2","11","11",0,0.0138249740762972,0,"0"
"371830540134013","1","4","1","6","1","4","1","6","5","11","11",237,0.0349702065678114,6777.19759934586,"76"
"371830527071017","3","3","4","10","3","3","4","10","2","12","12",0,0.000321731421100741,0,"0"
"371830540151015","3","3","3","9","3","3","3","9","3","12","12",615,0.119405016532714,5150.53737153084,"223"
"371830511021005","4","5","5","14","4","5","5","14","5","19","19",0,0.000928945805900264,0,"0"
"371830517003017","3","3","4","10","5","3","5","13","5","15","18",63,0.0458814262925869,1373.10465455558,"32"
"371830506003011","5","5","5","15","5","5","5","15","4","19","19",21,0.00347513731193156,6042.92668606172,"12"
"371830540131052","3","5","3","11","3","5","3","11","5","16","16",44,0.0122332813300228,3596.74553482356,"18"
"371830540171040","2","3","2","7","3","4","3","10","2","9","12",0,0.00464277259639817,0,"0"
"371830520012020","4","4","5","13","4","5","5","14","3","16","17",1,0.00736283575204365,135.817235868998,"1"
"371830540141086","1","3","2","6","2","4","3","9","4","10","13",43,0.0210976802240092,2038.13876897546,"17"
"371830540042002","3","3","4","10","3","3","4","10","2","12","12",158,0.0372216145787778,4244.84541544001,"71"
"371830512003027","5","5","5","15","5","5","5","15","4","19","19",41,0.00611925788120677,6700.15887480697,"18"
"371830514003000","4","5","5","14","4","5","5","14","4","18","18",321,0.0506345376856261,6339.54637826434,"206"
"371830538084016","3","3","3","9","3","3","3","9","4","13","13",0,0.0139325456750486,0,"0"
"371830506003016","5","5","5","15","5","5","5","15","4","19","19",75,0.00417567584329365,17961.1643275552,"34"
"371830506003014","5","4","5","14","5","5","5","15","4","18","19",46,0.00477751842335177,9628.42964145552,"21"
"371830506002035","5","5","5","15","5","5","5","15","4","19","19",15,0.00472005214832626,3177.93099072413,"5"
"371830506002013","5","4","5","14","5","5","5","15","3","17","18",18,0.0038399245023125,4687.59216207504,"9"
"371830508001018","5","5","5","15","5","5","5","15","4","19","19",57,0.00716799853643124,7952.01055222017,"26"
"371830517002000","3","4","4","11","4","4","5","13","4","15","17",226,0.121358734299029,1862.24750369541,"84"
"371830517002009","3","4","5","12","5","5","5","15","4","16","19",27,0.00797638290575529,3384.99296222582,"12"
"371830528033002","2","2","3","7","4","3","4","11","3","10","14",92,0.00750518640720342,12258.1898714333,"25"
"371830507002011","5","5","5","15","5","5","5","15","5","20","20",32,0.00436444358221873,7331.97700856344,"13"
"371830541101009","2","1","1","4","2","2","1","5","3","7","8",94,0.0109099777201695,8615.96626601903,"26"
"371830536102019","3","5","1","9","3","5","2","10","1","10","11",23,0.00312168299915761,7367.82050137909,"15"
"371830538081020","3","3","3","9","3","3","3","9","4","13","13",0,0.0225273134574495,0,"0"
"371830517002016","3","4","5","12","4","4","5","13","3","15","16",72,0.0116140164714302,6199.40570750146,"32"
"371830507003035","5","5","5","15","5","5","5","15","4","19","19",11,0.00312006502170737,3525.56755178793,"8"
"371830541043035","2","3","3","8","4","4","3","11","3","11","14",34,0.00696087515107232,4884.44330089189,"14"
"371830540162000","2","4","2","8","2","4","3","9","3","11","12",0,0.433069137367057,0,"0"
"371830540134015","2","5","2","9","2","5","2","9","5","14","14",35,0.00504416187889292,6938.71466466134,"13"
"371830541053000","1","2","2","5","1","2","2","5","5","10","10",123,0.235335093480267,522.658980354385,"47"
"371830503001031","5","5","5","15","5","5","5","15","3","18","18",27,0.0114746999360509,2353.00270599427,"16"
"371830541103001","1","1","1","3","2","2","1","5","3","6","8",58,0.162385785193047,357.174120450558,"22"
"371830542081127","2","4","1","7","2","5","1","8","3","10","11",89,0.0117266292369369,7589.56373581462,"32"
"371830503001006","5","5","5","15","5","5","5","15","3","18","18",50,0.00941771334540874,5309.14439271776,"28"
"371830525031000","1","5","2","8","1","5","2","8","3","11","11",0,0.12530967703405,0,"0"
"371830515011000","5","4","4","13","5","4","5","14","5","18","19",0,0.00325614288648063,0,"0"
"371830524011077","1","5","2","8","1","5","3","9","3","11","12",0,0.0910427501831163,0,"0"
"371830524011054","1","5","3","9","2","5","4","11","5","14","16",0,0.0818228045032613,0,"0"
"371830524041015","4","5","4","13","4","5","4","13","5","18","18",248,0.0871764243647356,2844.8058268873,"84"
"371830518001032","5","4","5","14","5","5","5","15","3","17","18",38,0.00701362840214995,5418.0230005273,"20"
"371830523011001","4","5","4","13","5","5","4","14","5","18","19",489,0.0787290953583117,6211.17260111353,"277"
"371830524042002","3","5","4","12","3","5","4","12","5","17","17",903,0.0486427140242924,18563.9312713727,"342"
"371830523021028","4","5","4","13","4","5","5","14","5","18","19",0,0.0205228565769272,0,"0"
"371830501001011","4","5","5","14","5","5","5","15","3","17","18",3,0.00523831456129164,572.703293186783,"2"
"371830521011015","2","2","3","7","2","2","4","8","2","9","10",97,0.0204523172660008,4742.73886613568,"31"
"371830528033050","1","1","2","4","2","2","2","6","3","7","9",120,0.0104821195508301,11448.0663398365,"35"
"371830528033015","2","2","3","7","2","3","4","9","3","10","12",45,0.00457301984719767,9840.32466589355,"16"
"371830541053021","5","3","2","10","5","3","2","10","5","15","15",54,0.00297626794552949,18143.5277294542,"26"
"371830542071110","2","4","1","7","2","5","1","8","3","10","11",855,0.0586000649109682,14590.4275242529,"354"
"371830528064057","2","1","1","4","2","2","1","5","4","8","9",6,0.0183320185997924,327.296198579459,"3"
"371830540181009","2","3","3","8","2","3","3","8","2","10","10",61,0.232819714562715,262.005303608292,"26"
"371830540141046","4","3","2","9","4","4","2","10","4","13","14",29,0.0021222051159914,13665.0316133332,"12"
"371830512001002","4","5","5","14","5","5","5","15","3","17","18",81,0.013974191977694,5796.39954347949,"54"
"371830512001009","4","5","5","14","5","5","5","15","3","17","18",65,0.0101606591457621,6397.2227655241,"45"
"371830523011003","5","5","4","14","5","5","4","14","5","19","19",0,0.0231725817202874,0,"0"
"371830523021037","5","5","5","15","5","5","5","15","5","20","20",12,0.0800059238742411,149.988893558212,"0"
"371830517001019","5","4","5","14","5","4","5","14","4","18","18",13,0.0066998626246242,1940.33829174657,"4"
"371830518002025","5","4","5","14","5","5","5","15","3","17","18",87,0.0118695532374279,7329.67772752098,"41"
"371830542091081","2","1","1","4","2","2","1","5","3","7","8",71,0.00585978522740245,12116.4850322463,"26"
"371830528064031","1","1","1","3","1","2","1","4","5","8","9",602,0.0976496124664289,6164.89901797575,"196"
"371830545002025","4","4","4","12","4","4","5","13","4","16","17",0,0.00675875661969236,0,"0"
"371830523022009","4","5","4","13","4","5","5","14","4","17","18",295,0.00941897280956493,31319.7634141622,"100"
"371830545002002","4","5","5","14","4","5","5","14","5","19","19",0,0.000175583599041573,0,"0"
"371830545003006","1","2","3","6","1","2","3","6","3","9","9",0,0.00254166326858244,0,"0"
"371830504001031","5","5","5","15","5","5","5","15","3","18","18",4,0.0239750177441117,166.840335331239,"2"
"371830536102026","4","5","1","10","4","5","2","11","1","11","12",39,0.00259766202705603,15013.5004453214,"17"
"371830540151031","4","3","3","10","4","4","3","11","2","12","13",85,0.0600896730887639,1414.55254506775,"36"
"371830540171017","2","4","3","9","2","4","3","9","3","12","12",5,0.00350212121994541,1427.70614892592,"3"
"371830540082016","2","3","3","8","3","4","4","11","2","10","13",259,0.0231741699928558,11176.2363044651,"92"
"371830541043047","3","2","3","8","5","3","3","11","2","10","13",2,0.00595683310912223,335.748872490187,"1"
"371830540151040","4","4","3","11","4","4","3","11","2","13","13",15,0.0167290435991953,896.644205094997,"8"
"371830541041047","3","2","3","8","3","3","3","9","2","10","11",0,0.00233283870424541,0,"0"
"371830541044015","2","3","2","7","3","3","3","9","3","10","12",267,0.0502758433959918,5310.7015609267,"109"
"371830540131029","1","5","2","8","1","5","2","8","4","12","12",143,0.0349494044090962,4091.62909691192,"42"
"371830540171011","2","4","3","9","2","4","3","9","3","12","12",415,0.0671627916139263,6179.0165362029,"135"
"371830540163005","3","5","3","11","3","5","3","11","5","16","16",87,0.0140978598076977,6171.14946429643,"34"
"371830540163017","2","4","2","8","2","5","3","10","5","13","15",130,0.0218883405003701,5939.23509175132,"50"
"371830515011021","3","3","4","10","4","3","5","12","4","14","16",0,0.00109924257895512,0,"0"
"371830516002021","5","3","4","12","5","3","5","13","3","15","16",71,0.0191286433659355,3711.71120929766,"30"
"371830523021052","4","5","5","14","4","5","5","14","5","19","19",1,0.00444024473566974,225.2128113495,"1"
"371830518001007","3","4","5","12","4","4","5","13","4","16","17",0,0.0112392141675482,0,"0"
"371830540171032","2","3","3","8","2","3","3","8","2","10","10",327,0.0468671062797687,6977.17495183093,"74"
"371830538082011","2","1","2","5","2","2","3","7","3","8","10",66,0.0330798238027886,1995.1738677168,"20"
"371830530081043","3","5","2","10","3","5","2","10","3","13","13",4,0.00539409088724818,741.552206592614,"2"
"371830545003012","1","2","3","6","1","2","3","6","2","8","8",84,0.0126557164702765,6637.3168360151,"40"
"371830510002027","5","5","5","15","5","5","5","15","5","20","20",0,0.00152151543028657,0,"0"
"371830541051027","3","2","2","7","3","2","2","7","3","10","10",0,0.00347946555052376,0,"0"
"371830503002017","4","5","5","14","4","5","5","14","4","18","18",47,0.00569088769170376,8258.81699765699,"25"
"371830503002006","4","5","5","14","5","5","5","15","3","17","18",49,0.00483425287761761,10136.0026544883,"38"
"371830501001036","5","5","5","15","5","5","5","15","4","19","19",0,0.00479821741038614,0,"0"
"371830528033038","2","2","4","8","2","2","4","8","3","11","11",269,0.0587162970209345,4581.35157780968,"123"
"371830528061027","2","2","2","6","3","3","3","9","3","9","12",7,0.0361519250569172,193.627309997442,"2"
"371830545002039","2","2","3","7","2","2","4","8","3","10","11",0,0.00486055989561413,0,"0"
"371830541062011","3","4","3","10","3","4","4","11","3","13","14",0,0.00478479458828169,0,"0"
"371830537113016","3","5","3","11","3","5","3","11","5","16","16",154,0.0369559328882354,4167.12522088773,"83"
"371830537113018","4","5","3","12","4","5","3","12","5","17","17",23,0.0176985642640506,1299.54044050442,"16"
"371830541102040","1","1","1","3","4","2","2","8","2","5","10",8,0.0421911170597456,189.613372612805,"3"
"371830542091069","3","1","1","5","3","1","1","5","3","8","8",47,0.00545962395843736,8608.65150380288,"18"
"371830537181009","1","1","1","3","4","1","2","7","1","4","8",243,0.0380754023169273,6382.07307640105,"82"
"371830505003003","4","4","5","13","5","4","5","14","3","16","17",0,0.0195057785608583,0,"0"
"371830541044003","2","2","3","7","5","3","4","12","2","9","14",89,0.0109037869066783,8162.30184629613,"33"
"371830528063019","3","1","2","6","3","2","2","7","5","11","12",15,0.0102780880523558,1459.41540134616,"10"
"371830537122014","4","3","3","10","4","3","3","10","5","15","15",137,0.0662818271665511,2066.93155358784,"49"
"371830540141069","2","3","1","6","2","4","2","8","5","11","13",27,0.01853544279966,1456.66873415591,"8"
"371830510001019","4","5","5","14","5","5","5","15","4","18","19",0,0.00175293695365813,0,"0"
"371830542081114","1","4","1","6","1","5","1","7","2","8","9",580,0.246496770231813,2352.97200630479,"211"
"371830536101006","1","5","1","7","1","5","1","7","1","8","8",0,0.00223051851424014,0,"0"
"371839802001014","1","5","1","7","1","5","1","7","1","8","8",0,0.000444038623834595,0,"0"
"371830542071039","2","4","1","7","2","4","1","7","2","9","9",307,0.234163829422003,1311.04791358162,"129"
"371830537131009","3","2","3","8","3","2","3","8","5","13","13",282,0.0360632499175204,7819.5947576815,"172"
"371830540141033","2","2","1","5","2","3","2","7","4","9","11",357,0.0579114528571837,6164.58372889388,"107"
"371830540112003","3","4","3","10","3","4","3","10","3","13","13",69,0.0167740211357558,4113.50381888565,"29"
"371830521014005","4","4","5","13","4","4","5","13","4","17","17",0,0.00831531574894339,0,"0"
"371830523021049","4","5","5","14","4","5","5","14","4","18","18",0,0.0104300886727828,0,"0"
"371830525072013","1","1","2","4","1","1","2","4","4","8","8",515,0.130469026199079,3947.29703289252,"208"
"371830525052010","2","3","3","8","2","3","4","9","4","12","13",344,0.100414701461641,3425.79318558658,"121"
"371830501001094","5","5","5","15","5","5","5","15","5","20","20",394,0.00847531676805482,46487.9379476488,"256"
"371830524071016","3","5","4","12","4","5","4","13","3","15","16",153,0.0833726857490168,1835.13339681281,"57"
"371830514005001","5","4","5","14","5","4","5","14","3","17","17",44,0.00535288636440168,8219.86438804555,"32"
"371830506002039","5","4","5","14","5","5","5","15","4","18","19",0,0.000576151799105082,0,"0"
"371839801001034","3","5","2","10","3","5","2","10","2","12","12",0,0.251614537319632,0,"0"
"371830537223001","5","2","3","10","5","3","3","11","3","13","14",70,0.0156375155884706,4476.4144025289,"23"
"371830540071004","2","3","3","8","2","3","3","8","5","13","13",98,0.0306774731853274,3194.52646598261,"34"
"371830517003001","4","3","4","11","4","4","5","13","5","16","18",0,0.00323265663656376,0,"0"
"371830537232013","5","2","3","10","5","2","4","11","4","14","15",23,0.0119444273279004,1925.58415473594,"10"
"371830537142019","5","3","3","11","5","3","3","11","5","16","16",13,0.00921487061487105,1410.76316134276,"7"
"371830528061011","3","1","1","5","3","2","2","7","3","8","10",1,0.00353920953269813,282.548967717559,"1"
"371830528064022","2","1","1","4","2","2","1","5","3","7","8",172,0.0135893711307219,12656.9506672133,"53"
"371830528072008","3","1","2","6","3","3","2","8","3","9","11",15,0.0106136115792336,1413.27953147906,"15"
"371830523013016","5","5","4","14","5","5","4","14","5","19","19",167,0.0166240290827569,10045.6994612226,"111"
"371830540111005","1","4","2","7","1","4","3","8","3","10","11",270,0.112644544903448,2396.92033228441,"97"
"371830523013026","2","5","3","10","2","5","3","10","3","13","13",453,0.0500068881400176,9058.75204095114,"142"
"371830540132043","1","4","1","6","1","5","2","8","5","11","13",128,0.0137847588589346,9285.61763828293,"45"
"371830528061021","2","2","2","6","3","3","3","9","3","9","12",0,0.000603992167423743,0,"0"
"371830537121004","5","3","3","11","5","3","3","11","5","16","16",2,0.00299767654178481,667.183390910216,"2"
"371830537211035","3","1","2","6","3","1","2","6","3","9","9",5,0.0500637895353139,99.8725834861765,"2"
"371830537152015","3","4","3","10","3","4","4","11","4","14","15",12,0.001920971686668,6246.83855742532,"5"
"371830528072071","4","1","1","6","4","4","2","10","2","8","12",47,0.00633120911558204,7423.54250854328,"18"
"371830506002012","5","4","5","14","5","5","5","15","3","17","18",11,0.00411912573909754,2670.4695842594,"6"
"371830541044000","2","2","3","7","5","3","4","12","2","9","14",0,0.00304107166110994,0,"0"
"371830540181007","4","4","4","12","4","4","4","12","2","14","14",47,0.00545083059026265,8622.5391198106,"24"
"371830501001044","4","5","5","14","4","5","5","14","4","18","18",16,0.00841717093994757,1900.87621056436,"9"
"371830514003010","5","5","5","15","5","5","5","15","5","20","20",85,0.025657883343245,3312.82198390609,"32"
"371830537241030","3","5","2","10","3","5","2","10","3","13","13",230,0.0210387095472463,10932.2294451327,"85"
"371830537252004","2","5","2","9","2","5","2","9","3","12","12",83,0.0462935766656297,1792.90532247042,"30"
"371830540134005","1","4","1","6","1","4","1","6","5","11","11",107,0.00809995288454859,13209.9533818416,"26"
"371830527071015","2","3","3","8","2","3","4","9","2","10","11",46,0.00257799223906132,17843.3430880883,"20"
"371830541102039","1","1","1","3","1","1","1","3","2","5","5",182,0.019167178713125,9495.39849990403,"54"
"371830540132052","1","4","1","6","1","5","2","8","4","10","12",0,0.000850171172803512,0,"0"
"371830540132058","2","5","2","9","2","5","2","9","4","13","13",0,0.000672283010274261,0,"0"
"371830540141092","2","2","2","6","2","3","2","7","3","9","10",0,0.00601783726712645,0,"0"
"371830540151045","4","3","3","10","4","4","3","11","2","12","13",5,0.012357096558741,404.625793464661,"2"
"371830514002003","4","5","5","14","5","5","5","15","4","18","19",57,0.0109453668648381,5207.68291313394,"27"
"371830545001018","5","5","5","15","5","5","5","15","5","20","20",49,0.00542766484643904,9027.82345379112,"14"
"371830541041039","3","3","2","8","3","3","2","8","4","12","12",107,0.0158079574778372,6768.74290369354,"33"
"371830541043008","1","3","2","6","3","3","3","9","3","9","12",228,0.0314768398886838,7243.42090267988,"72"
"371830514001016","5","5","5","15","5","5","5","15","3","18","18",34,0.00942147554939245,3608.77654691706,"19"
"371830527042000","4","4","4","12","4","4","4","12","2","14","14",621,0.0530945203608188,11696.1222321968,"243"
"371830524043005","4","5","4","13","4","5","4","13","4","17","17",73,0.0238787211697458,3057.11513950298,"29"
"371830540171012","2","4","3","9","2","4","3","9","3","12","12",1,0.0203626654684615,49.1094842936374,"1"
"371830540042006","2","2","4","8","2","3","4","9","2","10","11",91,0.0298078430672285,3052.88778509598,"39"
"371830507001000","5","5","5","15","5","5","5","15","5","20","20",105,0.0253231921180429,4146.39669084953,"41"
"371830540042000","4","3","4","11","4","3","4","11","2","13","13",164,0.0314971197632127,5206.8252980879,"56"
"371830540042001","4","3","4","11","4","3","4","11","2","13","13",91,0.0183782779560148,4951.49764400086,"47"
"371830523021024","3","5","4","12","3","5","4","12","5","17","17",0,0.00485294661516256,0,"0"
"371830524071009","4","4","4","12","4","4","4","12","4","16","16",0,0.124941331221185,0,"0"
"371830511012016","3","5","4","12","3","5","4","12","3","15","15",0,0.0054267303915921,0,"0"
"371830524041004","5","5","4","14","5","5","4","14","3","17","17",39,0.0218634112567826,1783.8021497172,"18"
"371830524081016","5","5","4","14","5","5","4","14","3","17","17",122,0.0296538564704516,4114.13605247487,"63"
"371830507001007","5","5","5","15","5","5","5","15","5","20","20",54,0.00749853451817872,7201.40713749968,"20"
"371830527061038","2","2","4","8","2","3","5","10","5","13","15",0,0.0834496614444046,0,"0"
"371830519002021","4","4","5","13","4","4","5","13","4","17","17",26,0.00574786626260093,4523.41770182991,"12"
"371830519002012","4","4","5","13","4","4","5","13","4","17","17",49,0.0113692307804696,4309.87820954198,"23"
"371830517003006","3","3","4","10","4","3","5","12","5","15","17",119,0.0412479880725918,2884.98919730518,"41"
"371830517003013","3","3","4","10","5","3","5","13","5","15","18",103,0.0232249857920718,4434.87892402332,"36"
"371830506003023","5","5","5","15","5","5","5","15","4","19","19",39,0.00843129190418686,4625.62563877466,"15"
"371830506003003","5","5","5","15","5","5","5","15","4","19","19",47,0.0083025429750705,5660.91619653446,"22"
"371830514005009","5","5","5","15","5","5","5","15","3","18","18",35,0.00786893047600677,4447.87256752602,"15"
"371830516002010","3","4","5","12","4","4","5","13","3","15","16",39,0.0126075257537744,3093.39046865118,"19"
"371830516004007","4","4","5","13","4","4","5","13","3","16","16",135,0.0296901921215206,4546.9560940344,"45"
"371830515012029","4","4","4","12","4","4","5","13","3","15","16",45,0.0154044368090975,2921.23630079252,"20"
"371830524063011","1","2","2","5","3","2","2","7","2","7","9",171,0.00796258267076163,21475.4442208691,"97"
"371830528072066","3","1","1","5","3","2","1","6","2","7","8",15,0.0126502912804737,1185.74344791201,"5"
"371830524011020","3","5","2","10","3","5","2","10","4","14","14",0,0.00985950955082942,0,"0"
"371830537152000","4","4","4","12","4","4","4","12","5","17","17",193,0.107463334297294,1795.96139708517,"76"
"371830525033002","1","5","2","8","1","5","2","8","3","11","11",40,0.0882245976954475,453.388295836503,"20"
"371830525042011","3","5","4","12","3","5","4","12","5","17","17",0,0.00742936559982832,0,"0"
"371830524041026","5","5","4","14","5","5","4","14","5","19","19",0,0.000898952705817061,0,"0"
"371830525031018","2","5","2","9","2","5","3","10","4","13","14",11,0.00281216720449208,3911.57395706376,"7"
"371830537152016","3","4","3","10","3","4","4","11","4","14","15",57,0.0136014033916961,4190.74402534075,"22"
"371830540071003","3","1","2","6","3","1","3","7","4","10","11",56,0.0087006577076013,6436.2950344634,"17"
"371830537071005","2","2","3","7","2","2","3","7","3","10","10",165,0.0380124416657181,4340.68406999509,"85"
"371830537162001","4","4","4","12","4","4","4","12","4","16","16",43,0.00843652537137733,5096.88504533946,"13"
"371830537093036","1","5","1","7","1","5","1","7","2","9","9",21,0.00725038802552463,2896.39670677908,"9"
"371830528061002","2","1","1","4","2","1","1","4","4","8","8",292,0.0588146479568356,4964.74960139692,"108"
"371830524093002","5","5","4","14","5","5","5","15","4","18","19",2,0.00368886255056386,542.17254576056,"1"
"371830537231008","3","1","2","6","3","1","3","7","3","9","10",227,0.105184252607952,2158.11772553147,"84"
"371830537092012","1","5","1","7","1","5","1","7","2","9","9",12,0.0340120535597006,352.816097356093,"6"
"371830537093045","1","5","1","7","1","5","1","7","2","9","9",31,0.00653382049040422,4744.5441829214,"10"
"371830518003013","5","4","5","14","5","4","5","14","5","19","19",142,0.0134001668800738,10596.8829545814,"53"
"371830528033022","1","1","3","5","1","2","4","7","3","8","10",55,0.173055035732665,317.817969105296,"40"
"371830528072057","1","1","1","3","1","1","1","3","2","5","5",51,0.591374546393536,86.2397617736857,"17"
"371830545002090","1","5","3","9","1","5","3","9","2","11","11",0,0.00383235141769424,0,"0"
"371830518001010","4","4","5","13","5","4","5","14","3","16","17",97,0.0202592526999425,4787.93573665603,"63"
"371830525043009","5","3","4","12","5","3","4","12","5","17","17",4,0.00599815844281575,666.871346953326,"1"
"371830515012010","4","2","4","10","4","3","4","11","4","14","15",76,0.0217908677723926,3487.69956267121,"28"
"371830524012000","3","5","4","12","4","5","5","14","4","16","18",954,0.200760996340058,4751.91903503044,"0"
"371830526021001","3","3","4","10","3","3","4","10","2","12","12",72,0.0199920088261836,3601.43898624642,"32"
"371830509001024","5","5","5","15","5","5","5","15","5","20","20",0,0.00374149692733281,0,"0"
"371830510001020","4","5","5","14","5","5","5","15","4","18","19",18,0.00726130959950554,2478.89168659407,"14"
"371830501001007","4","5","5","14","4","5","5","14","4","18","18",0,0.0351646234869847,0,"0"
"371830524082007","5","5","4","14","5","5","5","15","4","18","19",54,0.00372924376105877,14480.1475741207,"16"
"371830540161009","4","5","3","12","4","5","3","12","4","16","16",41,0.00661219685892287,6200.66233277254,"15"
"371830540123001","4","5","4","13","4","5","4","13","2","15","15",72,0.058039878589779,1240.52637168472,"28"
"371830524082008","5","5","4","14","5","5","5","15","4","18","19",61,0.0100531675125312,6067.73933926434,"22"
"371830523021035","5","5","5","15","5","5","5","15","5","20","20",0,0.0249518372068318,0,"0"
"371830524092000","3","5","4","12","3","5","5","13","4","16","17",1226,0.0701328040680185,17481.1205154575,"211"
"371830523021027","3","5","4","12","3","5","5","13","5","17","18",0,0.226265106643342,0,"0"
"371830511022007","4","5","5","14","4","5","5","14","5","19","19",422,0.03843839503896,10978.6061455551,"0"
"371830511023010","5","5","5","15","5","5","5","15","5","20","20",0,0.00608974086669648,0,"0"
"371830512003022","5","5","5","15","5","5","5","15","4","19","19",33,0.00929939918174113,3548.61635198903,"16"
"371830540151022","3","3","2","8","3","3","3","9","3","11","12",248,0.0342617354437784,7238.39574346589,"83"
"371830540041009","3","3","4","10","3","3","4","10","3","13","13",235,0.022140183948261,10614.1846223666,"209"
"371830501001061","4","5","5","14","4","5","5","14","4","18","18",0,0.00266963748160635,0,"0"
"371830540111011","2","4","3","9","2","4","3","9","3","12","12",248,0.0738958463550285,3356.07496541142,"90"
"371830540041006","4","4","4","12","4","4","4","12","2","14","14",180,0.0452535208703519,3977.59105895179,"117"
"371830528062056","2","1","2","5","2","2","3","7","3","8","10",0,0.00951183584078217,0,"0"
"371830540123002","2","3","3","8","2","3","3","8","2","10","10",417,0.345286308209672,1207.69341293076,"170"
"371830540182010","2","2","3","7","2","3","3","8","2","9","10",61,0.00323694686417717,18844.9185481165,"27"
"371830540133000","1","4","1","6","1","4","1","6","4","10","10",993,0.10868283016343,9136.67778532075,"457"
"371830545002027","3","3","4","10","3","3","4","10","3","13","13",0,0.00919815591184698,0,"0"
"371830512003000","5","5","5","15","5","5","5","15","3","18","18",70,0.0122781769537591,5701.17210915166,"37"
"371830509001022","4","5","5","14","4","5","5","14","4","18","18",0,0.0163430266522902,0,"0"
"371830524072009","3","5","3","11","4","5","4","13","3","14","16",140,0.0284099867746895,4927.84460303679,"86"
"371830517003024","3","3","4","10","5","3","5","13","5","15","18",0,0.0015445796524447,0,"0"
"371830520023002","4","3","4","11","5","3","5","13","5","16","18",283,0.308921161788898,916.09133657664,"98"
"371830530081006","1","3","2","6","3","4","2","9","3","9","12",0,0.00500642851338866,0,"0"
"371830524061004","3","4","3","10","3","4","3","10","3","13","13",135,0.0113918897019743,11850.5360859141,"62"
"371830524061009","2","4","2","8","3","4","3","10","3","11","13",274,0.0261235720093412,10488.6115842819,"99"
"371830514005006","5","5","5","15","5","5","5","15","3","18","18",33,0.00383851969218172,8597.06414095368,"12"
"371830527062015","1","2","3","6","1","2","4","7","3","9","10",0,0.00846841348127277,0,"0"
"371830530082000","2","3","2","7","2","3","2","7","2","9","9",371,1.1011437082446,336.922417321381,"131"
"371830508001011","5","5","5","15","5","5","5","15","5","20","20",0,0.000195389404115131,0,"0"
"371830545002047","1","2","3","6","1","2","3","6","2","8","8",3,0.0875780387194252,34.2551630964372,"1"
"371830528033006","2","1","2","5","2","2","3","7","3","8","10",48,0.0209328529099674,2293.04625635354,"14"
"371830530091000","2","5","2","9","2","5","2","9","2","11","11",40,1.37777400661676,29.0323375298851,"19"
"371830524012008","5","4","4","13","5","4","5","14","5","18","19",0,0.00309385803378286,0,"0"
"371830540011002","4","4","4","12","4","4","4","12","3","15","15",77,0.0141655992257386,5435.70369124185,"39"
"371830541062050","4","2","2","8","4","3","3","10","5","13","15",22,0.0125113040580829,1758.40982665487,"10"
"371830521011002","3","3","4","10","3","4","4","11","3","13","14",349,0.132566296432109,2632.64501908094,"122"
"371830536102003","1","5","1","7","1","5","2","8","1","8","9",0,0.000318496291707459,0,"0"
"371830536101016","2","5","1","8","2","5","1","8","1","9","9",78,0.0113112941984336,6895.76264498554,"21"
"371830501001034","4","5","5","14","4","5","5","14","4","18","18",0,0.00243827583127803,0,"0"
"371839801001017","2","1","1","4","2","1","1","4","1","5","5",0,0.36632242216311,0,"0"
"371830537191005","1","1","1","3","3","1","1","5","1","4","6",59,0.00474314686374327,12438.9991908109,"23"
"371830537181025","1","1","1","3","4","1","1","6","1","4","7",169,0.021521703791669,7852.53814641847,"52"
"371830525043010","5","3","4","12","5","3","4","12","4","16","16",5,0.00273762594701794,1826.39998917545,"3"
"371830524062002","1","5","2","8","2","5","2","9","3","11","12",0,0.00913513229748624,0,"0"
"371830525033014","2","5","3","10","2","5","3","10","4","14","14",0,0.00451582427261479,0,"0"
"371830501001020","5","5","5","15","5","5","5","15","4","19","19",36,0.00362722689999661,9924.9374225896,"21"
"371830537171020","1","5","1","7","2","5","1","8","1","8","9",1498,0.343400024167996,4362.25944837779,"787"
"371830537113003","5","5","3","13","5","5","3","13","5","18","18",69,0.0228268742650121,3022.75288324341,"25"
"371830537121018","5","3","3","11","5","3","3","11","5","16","16",53,0.00952074393864524,5566.79187483134,"19"
"371830537113012","3","5","2","10","3","5","2","10","4","14","14",97,0.0158663169086477,6113.58014329915,"56"
"371830537092004","1","5","2","8","1","5","2","8","3","11","11",898,0.225245777878373,3986.75619342751,"509"
"371830540011005","4","3","4","11","4","4","4","12","3","14","15",81,0.0230196792881612,3518.72843170572,"38"
"371830537151002","5","5","4","14","5","5","4","14","5","19","19",70,0.0221130250377984,3165.55513686377,"29"
"371830514005018","5","5","5","15","5","5","5","15","3","18","18",35,0.00402502991548722,8695.58754466135,"14"
"371839802001024","1","5","1","7","1","5","1","7","2","9","9",0,0.420200496900539,0,"0"
"371830537072013","4","4","4","12","4","4","4","12","4","16","16",0,0.000299278716299597,0,"0"
"371830540131043","3","5","3","11","3","5","3","11","5","16","16",0,0.000605414129073763,0,"0"
"371830525072007","2","2","2","6","2","2","2","6","3","9","9",383,0.12378831035095,3093.99166136256,"149"
"371830537223004","4","2","2","8","4","2","2","8","3","11","11",0,0.00709848761934611,0,"0"
"371830537252013","3","5","2","10","3","5","2","10","3","13","13",165,0.0371902330138957,4436.64872813112,"51"
"371830541043017","3","3","3","9","4","4","3","11","2","11","13",91,0.00362679388984088,25091.0315733417,"51"
"371830540162029","3","5","3","11","3","5","3","11","5","16","16",46,0.00845059255227176,5443.40526601698,"20"
"371830527051006","4","3","4","11","4","3","4","11","3","14","14",131,0.0380461074176582,3443.19061505881,"53"
"371830527072000","4","3","3","10","4","4","3","11","2","12","13",186,0.105284438075199,1766.64285245224,"78"
"371830540161008","4","5","3","12","4","5","3","12","4","16","16",50,0.0114548206587016,4364.97449325124,"22"
"371830512001001","4","4","5","13","4","5","5","14","3","16","17",31,0.00833454702790926,3719.4582856384,"16"
"371830512003020","5","5","5","15","5","5","5","15","4","19","19",45,0.0058603253713259,7678.75453130663,"20"
"371830528063009","4","1","2","7","4","2","2","8","3","10","11",247,0.0473621921434323,5215.13022986736,"88"
"371830501001101","5","5","5","15","5","5","5","15","5","20","20",2,0.00393117780946971,508.7533805218,"1"
"371830528063012","3","1","1","5","3","2","2","7","3","8","10",115,0.0123485315405312,9312.84822187471,"38"
"371830501001117","5","5","5","15","5","5","5","15","5","20","20",33,0.00844073864772553,3909.61044729092,"15"
"371830506003004","5","4","5","14","5","5","5","15","4","18","19",35,0.00579486842270109,6039.82652356512,"16"
"371830528062000","4","2","2","8","4","3","3","10","3","11","13",299,0.0366810421139428,8151.34965553085,"131"
"371830541103025","1","1","1","3","5","2","2","9","2","5","11",2,0.0143380277660901,139.489198418911,"1"
"371830512002008","5","5","5","15","5","5","5","15","3","18","18",57,0.00888260066412816,6417.03957605468,"29"
"371830509002030","5","5","5","15","5","5","5","15","5","20","20",186,0.00874009415135597,21281.2352795013,"54"
"371830509003008","5","5","5","15","5","5","5","15","5","20","20",40,0.00773887099699413,5168.71259587302,"17"
"371830504002008","5","4","5","14","5","4","5","14","3","17","17",4,0.0053828310443256,743.103390587871,"1"
"371830524012010","3","5","4","12","4","5","5","14","5","17","19",0,0.0827982447300649,0,"0"
"371830540163006","3","5","3","11","3","5","3","11","5","16","16",85,0.00860256141815184,9880.77804601845,"29"
"371830541042028","3","3","2","8","3","3","3","9","5","13","14",0,0.000213557254782557,0,"0"
"371830527041012","4","3","4","11","4","3","5","12","3","14","15",48,0.00373325553346959,12857.4107959307,"10"
"371830541042030","2","2","2","6","2","2","2","6","5","11","11",36,0.0457941998115945,786.125757150696,"13"
"371830545001023","4","5","5","14","4","5","5","14","4","18","18",33,0.00376970366969871,8754.00373383659,"8"
"371830525051010","3","4","3","10","3","4","4","11","4","14","15",8,0.000453497397035249,17640.6745712328,"3"
"371830537151001","4","5","4","13","4","5","4","13","5","18","18",21,0.00517401353892349,4058.74469442716,"9"
"371830540072017","3","2","3","8","3","2","3","8","4","12","12",221,0.0426172802707026,5185.68990316182,"97"
"371830537162012","4","5","4","13","4","5","4","13","5","18","18",22,0.00513035276529465,4288.20414627696,"8"
"371830537093055","1","5","1","7","1","5","1","7","3","10","10",0,1.5261661075828e-05,0,"0"
"371830537152008","2","3","3","8","2","3","3","8","3","11","11",1,0.00427979405001042,233.656103147666,"1"
"371830525051031","3","3","3","9","3","3","4","10","5","14","15",100,0.00272199369354522,36737.7779886611,"51"
"371830537143001","2","2","3","7","2","2","3","7","3","10","10",21,0.023001912625983,912.967558022907,"8"
"371830537143007","2","2","3","7","2","2","3","7","3","10","10",150,0.0256377701847776,5850.74282665434,"69"
"371830537142007","2","3","3","8","2","3","3","8","4","12","12",62,0.0185617026878356,3340.21081162083,"18"
"371830540072012","2","2","3","7","3","2","3","8","4","11","12",2,0.0287410231692453,69.5869450514249,"1"
"371830525061000","3","3","3","9","3","3","3","9","4","13","13",143,0.0747653385626487,1912.65100578893,"50"
"371830524093001","5","5","4","14","5","5","5","15","4","18","19",0,0.00588196089013727,0,"0"
"371830523023031","2","5","3","10","2","5","3","10","3","13","13",210,0.0122150237283861,17191.9436809596,"53"
"371830537111025","2","5","2","9","2","5","2","9","2","11","11",0,0.00202910345200124,0,"0"
"371830530081041","2","4","2","8","2","4","2","8","3","11","11",22,0.0135884437980947,1619.02277603597,"9"
"371830545002032","4","4","4","12","4","4","5","13","4","16","17",8,0.00271208950497068,2949.75515569737,"1"
"371839802001023","4","5","3","12","4","5","3","12","4","16","16",0,0.381840080804849,0,"0"
"371830545002009","4","4","4","12","4","4","5","13","4","16","17",0,0.00149648155755635,0,"0"
"371830528033034","2","2","4","8","2","2","4","8","2","10","10",264,0.0616038144612192,4285.44891755352,"91"
"371830519001040","5","4","5","14","5","4","5","14","3","17","17",50,0.0224051019391502,2231.6345685815,"17"
"371830545002011","5","4","4","13","5","4","5","14","4","17","18",37,0.0112509408203158,3288.61386713449,"23"
"371830528033060","1","2","2","5","2","2","3","7","3","8","10",0,0.047075403213009,0,"0"
"371830528033056","1","1","2","4","1","2","2","5","3","7","8",57,0.0119280205979786,4778.66378011282,"19"
"371830521021049","2","2","4","8","3","3","4","10","3","11","13",21,0.0277840860970426,755.828351764115,"10"
"371830528033019","2","2","4","8","2","3","4","9","3","11","12",6,0.0201182776375384,298.236265951748,"3"
"371830526012004","4","4","4","12","4","4","5","13","4","16","17",50,0.0116117051142335,4305.9998086509,"18"
"371830527043018","4","4","4","12","4","4","4","12","2","14","14",74,0.0177703994620675,4164.22828074064,"33"
"371830530081058","4","5","3","12","4","5","3","12","4","16","16",23,0.00421015461529869,5462.98226588248,"9"
"371830524042000","3","5","4","12","3","5","4","12","4","16","16",212,0.0747799014422869,2834.98635209644,"84"
"371830510002029","5","5","5","15","5","5","5","15","5","20","20",0,0.00167055499125741,0,"0"
"371830519001016","3","4","4","11","4","4","5","13","3","14","16",21,0.0038978788590189,5387.54557530958,"9"
"371830505001030","5","4","5","14","5","5","5","15","4","18","19",26,0.00300473285738257,8653.01550389698,"12"
"371830505001005","5","4","5","14","5","5","5","15","3","17","18",30,0.0136502226764428,2197.76634499695,"18"
"371830541062036","3","3","4","10","3","4","5","12","3","13","15",2,0.00244577720248502,817.735972830194,"1"
"371830506001005","5","4","5","14","5","5","5","15","3","17","18",94,0.0106368985961144,8837.16236933363,"34"
"371830542102045","1","1","1","3","1","1","1","3","3","6","6",14,0.00788731835108228,1775.00125858099,"3"
"371830503002009","5","5","5","15","5","5","5","15","4","19","19",288,0.00937063059883604,30734.3243298667,"232"
"371830521014001","3","4","4","11","3","4","5","12","4","15","16",0,0.00769311558461858,0,"0"
"371830545002029","2","3","3","8","2","3","4","9","3","11","12",0,0.0103147789221521,0,"0"
"371830536102045","4","1","2","7","4","1","2","7","1","8","8",8,0.01813138758348,441.223814954406,"3"
"371830541044016","2","3","3","8","4","3","3","10","3","11","13",71,0.0108760039138192,6528.13299467338,"21"
"371830501001077","5","5","5","15","5","5","5","15","4","19","19",0,0.00478250292686589,0,"0"
"371830509002012","4","5","5","14","4","5","5","14","5","19","19",203,0.0441708559202973,4595.79049965201,"0"
"371830510002021","5","5","5","15","5","5","5","15","5","20","20",36,0.00377105155717283,9546.40886081901,"16"
"371830510002023","5","5","5","15","5","5","5","15","5","20","20",15,0.006500197173228,2307.62230748625,"6"
"371830509001006","5","5","5","15","5","5","5","15","5","20","20",0,0.00566801770374628,0,"0"
"371830501001115","5","5","5","15","5","5","5","15","5","20","20",0,0.00846062229863951,0,"0"
"371830545001017","5","5","5","15","5","5","5","15","5","20","20",48,0.00587935333365616,8164.16317849544,"15"
"371830540043000","4","5","4","13","4","5","4","13","2","15","15",26,0.0194798913847121,1334.70970071244,"6"
"371830545001027","3","4","4","11","3","4","5","12","5","16","17",141,0.132690452764793,1062.62355024093,"18"
"371830545001052","4","4","4","12","4","4","5","13","4","16","17",0,0.00380632459993565,0,"0"
"371830501001071","5","5","5","15","5","5","5","15","5","20","20",0,0.00507972458795238,0,"0"
"371830524071012","2","5","4","11","2","5","4","11","3","14","14",247,0.0932228124027687,2649.56606257316,"192"
"371830524081012","5","5","4","14","5","5","5","15","4","18","19",33,0.00724754186921033,4553.26793491095,"17"
"371830524062012","1","5","2","8","2","5","3","10","3","11","13",0,0.00389098859884699,0,"0"
"371830517001005","5","3","4","12","5","4","5","14","5","17","19",31,0.00785763438797217,3945.20773929776,"9"
"371830519001019","5","4","5","14","5","4","5","14","4","18","18",69,0.0162585440973757,4243.92243159934,"22"
"371830520012010","3","4","5","12","4","4","5","13","3","15","16",22,0.0107100725618803,2054.14107821298,"9"
"371830527013006","2","2","4","8","2","3","4","9","3","11","12",1473,0.150700265126577,9774.36900169214,"382"
"371830528062024","5","5","4","14","5","5","5","15","4","18","19",0,0.246360891806505,0,"0"
"371830526021003","4","3","4","11","4","3","4","11","3","14","14",43,0.0176130687019174,2441.36900433023,"20"
"371830519001011","3","4","4","11","5","4","5","14","4","15","18",24,0.0166045161803984,1445.38990111208,"11"
"371830520021014","3","4","4","11","4","5","5","14","4","15","18",46,0.012852005449315,3579.20794395957,"20"
"371830520021015","4","4","4","12","4","5","5","14","5","17","19",40,0.010485006864854,3814.97127427555,"18"
"371830540134027","2","4","2","8","2","5","2","9","3","11","12",0,0.319223113910158,0,"0"
"371830540131050","4","5","3","12","4","5","3","12","5","17","17",0,0.0386573207057196,0,"0"
"371830540123004","3","4","4","11","3","4","4","11","2","13","13",38,0.010386404180413,3658.62904427131,"19"
"371830536102068","3","5","1","9","3","5","2","10","1","10","11",0,0.00490569465396047,0,"0"
"371839802001006","1","5","1","7","1","5","1","7","2","9","9",0,0.0224985564556118,0,"0"
"371830509001000","5","5","5","15","5","5","5","15","5","20","20",2,0.00276292471868662,723.870609457183,"3"
"371830541043007","1","2","2","5","3","2","2","7","2","7","9",198,0.017139151950221,11552.496913212,"60"
"371830527013004","5","3","4","12","5","3","5","13","3","15","16",67,0.00334631336079105,20022.0340345417,"23"
"371830541131002","1","1","1","3","2","2","2","6","3","6","9",119,0.670876722541252,177.379831497556,"49"
"371830524011001","4","5","3","12","4","5","3","12","5","17","17",195,0.114166960383385,1708.02480284286,"62"
"371830536102118","4","5","2","11","4","5","2","11","1","12","12",0,0.0281190475723709,0,"0"
"371830536102109","5","5","2","12","5","5","2","12","1","13","13",34,0.00347459618281327,9785.3097773426,"18"
"371830540162031","2","4","2","8","2","4","3","9","4","12","13",127,0.0176221039361621,7206.85795862237,"39"
"371830519003000","5","2","4","11","5","2","5","12","5","16","17",342,0.371095758685696,921.595011517395,"142"
"371830518002010","5","4","5","14","5","4","5","14","4","18","18",47,0.010430658665349,4505.94746774099,"22"
"371830537113007","4","5","2","11","4","5","2","11","4","15","15",320,0.0744947063449209,4295.6072411153,"140"
"371830545002085","2","4","4","10","2","4","4","10","4","14","14",0,0.00297451020358147,0,"0"
"371830542071070","1","2","1","4","1","2","1","4","2","6","6",90,0.188037192176284,478.628716789311,"31"
"371830542081128","2","5","1","8","2","5","1","8","3","11","11",55,0.0178625490441063,3079.06782308581,"15"
"371830536101034","1","1","1","3","1","1","1","3","1","4","4",143,0.112826140848856,1267.43677417422,"68"
"371830537191010","1","1","1","3","2","1","1","4","1","4","5",119,0.0213551224543769,5572.43351117426,"41"
"371830545003000","2","2","3","7","2","2","3","7","3","10","10",2221,0.429163979963288,5175.17802913,"651"
"371830528062027","2","1","2","5","2","2","3","7","2","7","9",31,0.00356601231507716,8693.18366314425,"10"
"371830537181019","1","5","1","7","2","5","2","9","2","9","11",48,0.116946223670369,410.445061785793,"25"
"371830537241005","2","5","1","8","2","5","2","9","2","10","11",0,0.00332488692494338,0,"0"
"371830527061028","4","3","4","11","4","3","4","11","3","14","14",0,0.0191281964331639,0,"0"
"371830541132040","5","3","2","10","5","4","2","11","5","15","16",84,0.00336740924372121,24944.9929962105,"35"
"371830541132042","5","3","2","10","5","3","2","10","5","15","15",0,0.0218622118229361,0,"0"
"371830510002026","5","5","5","15","5","5","5","15","5","20","20",55,0.00785020798251672,7006.18380079752,"24"
"371830536101052","1","1","1","3","1","1","1","3","1","4","4",100,0.0241501790759227,4140.7560451466,"32"
"371830510002008","5","5","5","15","5","5","5","15","5","20","20",37,0.00546291549670491,6772.94020424029,"22"
"371830536102034","5","5","2","12","5","5","2","12","1","13","13",29,0.00358205012823757,8095.922435979,"14"
"371830524011009","2","5","2","9","2","5","2","9","3","12","12",0,0.00240299345090668,0,"0"
"371830526023007","3","3","4","10","3","3","4","10","3","13","13",37,0.0188003709474698,1968.04627437309,"20"
"371830542102043","1","1","1","3","1","2","1","4","3","6","7",35,0.00328397401363724,10657.8188057082,"13"
"371830542071024","1","2","1","4","1","2","1","4","2","6","6",171,0.0356313037464104,4799.15080337826,"61"
"371830542071095","2","4","1","7","2","5","1","8","3","10","11",58,0.00599471670755568,9675.18613963815,"14"
"371830540141047","3","3","1","7","3","4","2","9","4","11","13",92,0.00514278490959905,17889.1401482262,"46"
"371830542071036","1","4","1","6","1","4","1","6","2","8","8",178,0.00668465348682057,26628.1566203759,"76"
"371830515011014","5","3","4","12","5","3","5","13","4","16","17",45,0.0133517387024162,3370.34756318715,"21"
"371830541103003","1","1","1","3","3","1","1","5","2","5","7",210,0.079085671449519,2655.3482590591,"84"
"371830541103016","1","1","1","3","4","1","1","6","2","5","8",31,0.00870499475958853,3561.17388420637,"10"
"371830528061014","3","1","1","5","3","1","1","5","3","8","8",13,0.018342039167079,708.75434740827,"4"
"371830528061010","5","3","2","10","5","4","3","12","3","13","15",21,0.0137132951679065,1531.36060610339,"7"
"371830541043003","2","2","2","6","4","3","3","10","2","8","12",70,0.0499854177041611,1400.40842339851,"24"
"371830541054023","2","2","2","6","2","2","3","7","4","10","11",6,0.00480261362554719,1249.31973875296,"2"
"371830527012031","2","3","4","9","2","3","5","10","3","12","13",0,0.0130413643849106,0,"0"
"371830528063004","5","2","2","9","5","3","3","11","4","13","15",0,0.000159954013753513,0,"0"
"371830541052021","2","3","3","8","2","3","3","8","3","11","11",136,0.0167032644276039,8142.12099613567,"46"
"371830541063019","5","3","2","10","5","4","3","12","5","15","17",176,0.0106412571956078,16539.3991297047,"76"
"371830540151038","4","4","3","11","4","4","3","11","2","13","13",254,0.0238479232088693,10650.8226219688,"124"
"371830540122006","4","5","4","13","4","5","4","13","2","15","15",273,0.0933327047922488,2925.01969816129,"106"
"371830509002010","5","5","5","15","5","5","5","15","5","20","20",0,0.00282651034932306,0,"0"
"371830518003010","5","4","5","14","5","4","5","14","5","19","19",206,0.033814821772426,6092.00312769298,"155"
"371830520021002","4","4","4","12","4","5","5","14","5","17","19",127,0.0219003569752746,5798.99223302078,"44"
"371830523021020","3","5","4","12","3","5","4","12","5","17","17",0,0.0335358834801029,0,"0"
"371830512002013","4","5","5","14","5","5","5","15","4","18","19",0,0.0072162896109677,0,"0"
"371830527063019","2","2","3","7","2","3","4","9","3","10","12",157,0.015059430931391,10425.3607400753,"11"
"371830527041010","5","3","4","12","5","3","4","12","2","14","14",157,0.0101211397365801,15512.0869868605,"51"
"371830540181016","3","3","4","10","3","3","4","10","2","12","12",0,0.0931738713670548,0,"0"
"371830527042006","5","3","4","12","5","3","4","12","2","14","14",0,0.0463114426139948,0,"0"
"371830537241013","5","5","3","13","5","5","3","13","2","15","15",0,0.000851792118516197,0,"0"
"371830537121017","5","3","3","11","5","3","3","11","5","16","16",7,0.00497366406752129,1407.41310731277,"3"
"371830509001008","5","5","5","15","5","5","5","15","5","20","20",13,0.00522388200508553,2488.57075778976,"4"
"371830518001037","4","4","5","13","4","4","5","13","3","16","16",56,0.00315417796533608,17754.2296647276,"40"
"371830520012006","3","4","4","11","5","5","5","15","4","15","19",0,0.0233974624627386,0,"0"
"371830524062032","2","5","3","10","2","5","3","10","3","13","13",50,0.0136358214084977,3666.81247151276,"19"
"371830515022026","4","4","4","12","4","5","5","14","5","17","19",70,0.0392554466913771,1783.19203830067,"32"
"371830540111006","1","3","3","7","1","3","3","7","3","10","10",100,0.0229076083881669,4365.3618616798,"31"
"371830506001009","5","4","5","14","5","5","5","15","3","17","18",16,0.00224353337040822,7131.60776257531,"8"
"371830541044019","2","3","2","7","3","3","3","9","2","9","11",287,0.0334370218910733,8583.30029914001,"86"
"371830541052009","1","2","2","5","1","2","2","5","3","8","8",4,0.00258044391273286,1550.12088434185,"1"
"371830527051001","4","3","4","11","4","3","4","11","2","13","13",0,0.0268791650962206,0,"0"
"371830540163012","2","5","3","10","2","5","3","10","4","14","14",66,0.0101256618590242,6518.09243868628,"48"
"371830538082009","2","1","2","5","2","1","3","6","3","8","9",317,0.172336056341182,1839.42934943585,"93"
"371830538071027","4","3","3","10","4","3","3","10","3","13","13",0,0.00530551619902084,0,"0"
"371830537251016","4","5","3","12","4","5","3","12","4","16","16",0,0.000246629524678577,0,"0"
"371830540163010","2","5","2","9","2","5","3","10","4","13","14",28,0.00202939825903469,13797.1932691608,"19"
"371830540163002","3","5","3","11","3","5","3","11","5","16","16",48,0.00869928330216857,5517.69592191974,"21"
"371830540134017","3","5","3","11","3","5","3","11","5","16","16",0,0.000706141913314296,0,"0"
"371830515021001","4","5","4","13","4","5","4","13","5","18","18",525,0.115697902406734,4537.6795004837,"139"
"371830540162006","2","4","2","8","2","4","3","9","4","12","13",304,0.0669944070522737,4537.69222500616,"112"
"371830540082000","4","3","3","10","4","3","3","10","2","12","12",781,0.0598422313489887,13050.9839354979,"317"
"371830527043005","4","4","4","12","4","4","4","12","2","14","14",12,0.0073189435416506,1639.58089466198,"4"
"371830540151029","2","2","2","6","2","3","3","8","3","9","11",545,0.108710614460353,5013.30990267525,"228"
"371830540181017","3","3","3","9","3","3","4","10","2","11","12",2,0.134599333900222,14.8589145432368,"1"
"371830516002012","4","4","4","12","4","4","5","13","3","15","16",24,0.00472257425439635,5081.97409022375,"7"
"371830515012018","3","2","4","9","3","3","5","11","4","13","15",62,0.0192871012385149,3214.58363458946,"20"
"371830515022005","5","3","4","12","5","3","5","13","4","16","17",41,0.0130980753022444,3130.23089682301,"22"
"371830540132005","5","5","2","12","5","5","3","13","5","17","18",49,0.0231438531180188,2117.19283518312,"21"
"371830520023006","4","2","4","10","5","3","4","12","5","15","17",108,0.0243950548028134,4427.12676290215,"40"
"371830540171010","2","4","3","9","2","4","3","9","3","12","12",13,0.00295969123806286,4392.350064363,"5"
"371830540082012","2","3","3","8","3","3","3","9","2","10","11",22,0.0014273767317497,15412.8896111625,"16"
"371830540141018","2","2","1","5","2","3","2","7","4","9","11",0,0.000183475479136161,0,"0"
"371830540141034","1","2","1","4","1","3","2","6","4","8","10",49,0.0032985732180652,14854.9074889844,"21"
"371830545001026","5","5","5","15","5","5","5","15","5","20","20",58,0.0101232307251244,5729.39623474671,"22"
"371830528033051","2","1","2","5","2","2","2","6","3","8","9",80,0.00477696463819633,16747.0362581972,"18"
"371830540132008","1","3","1","5","1","4","1","6","5","10","11",34,0.0100120325425514,3395.91385220726,"11"
"371830540162010","4","5","3","12","4","5","3","12","5","17","17",94,0.0134688315065709,6979.07609536443,"37"
"371830538082017","1","1","2","4","3","1","3","7","4","8","11",54,0.111827343853717,482.887262981386,"21"
"371830536101029","1","1","1","3","1","1","1","3","1","4","4",15,0.00226713143889349,6616.29041116425,"7"
"371830536102004","1","5","1","7","1","5","1","7","1","8","8",0,0.0191496340949695,0,"0"
"371830525033010","5","5","3","13","5","5","3","13","5","18","18",0,0.0799799562090237,0,"0"
"371830528061015","2","1","2","5","3","3","3","9","5","10","14",0,0.0712334805941902,0,"0"
"371830536102041","5","1","2","8","5","1","2","8","1","9","9",0,0.0120408144788553,0,"0"
"371830526022006","2","3","4","9","2","3","5","10","3","12","13",0,0.00339555099192004,0,"0"
"371830520022010","4","4","4","12","4","4","5","13","5","17","18",40,0.0061546535057763,6499.1473463874,"13"
"371830519001006","2","4","4","10","4","4","5","13","4","14","17",28,0.016728172682471,1673.82298900707,"13"
"371830520023008","3","4","4","11","4","5","5","14","5","16","19",73,0.0152890782879326,4774.65015386949,"27"
"371830520021001","4","4","4","12","4","5","5","14","4","16","18",129,0.0168731739488912,7645.27174263364,"41"
"371830541102053","1","1","1","3","2","1","1","4","2","5","6",114,0.0135633605250634,8404.99666652245,"33"
"371830526012017","3","3","4","10","3","3","5","11","4","14","15",0,0.00905381528082942,0,"0"
"371830527052010","5","2","4","11","5","3","4","12","3","14","15",777,0.107397489782323,7234.80596776379,"245"
"371830541044013","2","2","2","6","3","3","3","9","2","8","11",356,0.0578097886569449,6158.12664724614,"113"
"371830509002029","4","4","4","12","4","5","5","14","4","16","18",0,0.00314585986881927,0,"0"
"371830526011000","2","3","4","9","3","3","4","10","3","12","13",29,0.0205476493991739,1411.35365104905,"12"
"371830526012015","3","3","4","10","3","3","5","11","4","14","15",66,0.0173462422392748,3804.85865985227,"27"
"371830541053017","4","2","1","7","4","2","2","8","4","11","12",145,0.0289807250785496,5003.3254726026,"65"
"371830540131024","1","5","2","8","1","5","2","8","5","13","13",125,0.0238766877901275,5235.23200113564,"43"
"371830541041045","3","3","3","9","4","4","3","11","2","11","13",86,0.00276717004945567,31078.6827202459,"46"
"371830527043024","2","3","3","8","2","3","4","9","2","10","11",0,0.000961499353077362,0,"0"
"371830527043010","4","2","3","9","4","3","4","11","2","11","13",32,0.00682001547135312,4692.07146734684,"10"
"371830527043019","4","3","4","11","4","3","4","11","2","13","13",0,0.0119482024667457,0,"0"
"371830540131025","1","4","2","7","1","5","2","8","5","12","13",182,0.0248943720460138,7310.88937144501,"68"
"371830540131020","3","5","2","10","3","5","2","10","3","13","13",50,0.0286291640834082,1746.47083143364,"17"
"371830527061013","4","3","3","10","4","3","4","11","3","13","14",90,0.00924027789114212,9739.96681271625,"34"
"371830537252000","2","5","2","9","2","5","2","9","3","12","12",0,0.000809275295962001,0,"0"
"371830541053006","1","2","2","5","1","2","2","5","4","9","9",0,0.000881053552864548,0,"0"
"371830519001037","5","4","5","14","5","5","5","15","3","17","18",54,0.00643707947845585,8388.89750868102,"17"
"371830541051011","5","3","2","10","5","3","2","10","5","15","15",0,0.0108940944597243,0,"0"
"371830540143032","2","2","2","6","2","2","2","6","3","9","9",0,0.00943965663574928,0,"0"
"371830540181004","3","3","4","10","3","3","4","10","2","12","12",2,0.0976177568005812,20.4880757922527,"1"
"371830540041002","4","4","4","12","4","4","4","12","2","14","14",103,0.0283754355734051,3629.90022597352,"46"
"371830541061033","2","1","2","5","2","2","3","7","3","8","10",0,0.000472559650986687,0,"0"
"371830503002013","4","5","5","14","4","5","5","14","4","18","18",229,0.00497106403714621,46066.5962636572,"170"
"371830506003020","5","5","5","15","5","5","5","15","5","20","20",104,0.0153147916045486,6790.82044897767,"48"
"371830501001042","4","5","5","14","4","5","5","14","4","18","18",0,0.0087162619036768,0,"0"
"371830501001106","5","5","5","15","5","5","5","15","5","20","20",183,0.00478556345873164,38240.0111456264,"113"
"371830519001017","3","4","4","11","5","4","5","14","4","15","18",24,0.00850404880377142,2822.18512073406,"9"
"371830509001014","5","5","5","15","5","5","5","15","5","20","20",0,0.0162873830270926,0,"0"
"371830541101008","2","1","1","4","2","1","1","4","3","7","7",187,0.031718789722333,5895.55911927921,"52"
"371830509003005","5","5","5","15","5","5","5","15","5","20","20",25,0.00336969498470959,7419.06911855246,"10"
"371830509003009","5","5","5","15","5","5","5","15","5","20","20",40,0.00514843161418118,7769.35637832333,"16"
"371830514005003","5","4","5","14","5","4","5","14","3","17","17",30,0.00652473427887244,4597.8883917376,"15"
"371830514004012","4","5","5","14","4","5","5","14","5","19","19",31,0.00720761947556501,4301.00397296153,"19"
"371830528062018","4","3","3","10","4","4","4","12","3","13","15",5,0.0405830549446899,123.204130561744,"3"
"371830527052037","2","2","4","8","2","3","5","10","5","13","15",525,0.0483999739503126,10847.1132761138,"382"
"371830521021021","4","3","4","11","4","4","4","12","3","14","15",48,0.00444215696845073,10805.5614290327,"15"
"371830507003019","5","4","5","14","5","5","5","15","4","18","19",91,0.0113258193307547,8034.73879835733,"33"
"371830528064055","1","1","1","3","1","2","1","4","4","7","8",116,0.0196429605930896,5905.42344420366,"38"
"371830541101003","4","2","1","7","4","3","2","9","4","11","13",77,0.0130492033987853,5900.74333634556,"31"
"371830542081087","1","4","1","6","1","5","1","7","2","8","9",29,0.00775933090912283,3737.43565516764,"18"
"371830507003007","5","4","5","14","5","4","5","14","3","17","17",20,0.00230992125510796,8658.30380831108,"8"
"371830540141014","3","2","1","6","3","3","2","8","5","11","13",1490,0.662901464864164,2247.69453527353,"533"
"371830508002002","5","5","5","15","5","5","5","15","5","20","20",109,0.0140725474098895,7745.57703201628,"37"
"371830540112004","2","4","3","9","2","4","3","9","3","12","12",241,0.0676012408781448,3565.02331716686,"95"
"371830538082024","4","4","3","11","4","4","4","12","5","16","17",0,0.0135591037541801,0,"0"
"371830536102049","2","1","1","4","2","1","1","4","1","5","5",0,0.00217063554502133,0,"0"
"371830512003013","5","5","5","15","5","5","5","15","4","19","19",53,0.00549047741559627,9653.07677060068,"16"
"371830528072064","2","1","1","4","5","5","2","12","2","6","14",20,0.00957119391935418,2089.60346729131,"8"
"371830541052015","2","3","2","7","2","3","3","8","3","10","11",0,4.33252468052093e-05,0,"0"
"371830527073011","4","4","3","11","4","4","3","11","3","14","14",45,0.00432238866916949,10410.9101342444,"16"
"371830541043037","1","3","3","7","5","4","4","13","2","9","15",56,0.00302337442145149,18522.3502595867,"18"
"371830541102050","1","1","1","3","1","1","1","3","3","6","6",189,0.0273679385892876,6905.89097104956,"66"
"371830505003001","3","4","5","12","4","4","5","13","3","15","16",0,0.0458571478153837,0,"0"
"371830505002003","4","4","5","13","4","5","5","14","3","16","17",447,0.107500230129829,4158.13063339635,"194"
"371830527052031","2","2","4","8","2","3","5","10","5","13","15",0,0.00366988154425248,0,"0"
"371830524072005","3","5","4","12","4","5","4","13","3","15","16",49,0.00968625818798832,5058.71297760405,"15"
"371830524072023","5","5","4","14","5","5","4","14","3","17","17",4,0.0105390699513062,379.540131954836,"1"
"371830524041010","4","5","4","13","4","5","4","13","4","17","17",74,0.0258928340322202,2857.93358532777,"31"
"371830541063025","3","3","2","8","3","3","2","8","4","12","12",47,0.00442437473396638,10622.9699847023,"14"
"371830521011008","3","3","4","10","3","3","4","10","3","13","13",572,0.225639681821029,2535.01509744946,"170"
"371830521021028","5","4","5","14","5","4","5","14","3","17","17",111,0.0218407037391436,5082.25381955354,"33"
"371830521021038","5","4","5","14","5","4","5","14","3","17","17",45,0.0119231218187602,3774.17933692464,"19"
"371830537222004","3","2","3","8","3","2","3","8","3","11","11",45,0.0201789998643624,2230.04114685948,"17"
"371830537231003","3","2","3","8","3","2","3","8","3","11","11",31,0.00203622780260675,15224.2298039121,"18"
"371830537231000","3","1","2","6","3","2","3","8","3","9","11",0,0.0761615177830389,0,"0"
"371830525071010","3","2","3","8","3","2","3","8","4","12","12",0,0.00193477227722486,0,"0"
"371830537122016","5","3","3","11","5","3","3","11","5","16","16",33,0.0207419051356777,1590.98211008773,"12"
"371830540071000","2","3","3","8","2","3","3","8","5","13","13",170,0.130787983627072,1299.81360126124,"74"
"371830537261014","4","5","3","12","4","5","3","12","4","16","16",72,0.00784776386511653,9174.58797658802,"38"
"371830545002041","2","3","3","8","2","3","4","9","3","11","12",0,0.00163976715558373,0,"0"
"371830528033045","1","1","2","4","1","2","3","6","3","7","9",0,0.0928700497410624,0,"0"
"371830528064036","1","1","1","3","1","2","1","4","4","7","8",109,0.0149139178238456,7308.60940012165,"48"
"371830528072020","4","2","2","8","4","3","2","9","3","11","12",11,0.00236137531989149,4658.30226450638,"6"
"371830540121010","1","4","3","8","1","4","4","9","3","11","12",68,0.0227328412726465,2991.26709171289,"23"
"371830528071005","1","1","1","3","2","2","1","5","3","6","8",87,0.192224531707258,452.595718284771,"31"
"371830537111012","4","1","2","7","4","1","2","7","3","10","10",0,0.00204139895262122,0,"0"
"371830537251000","5","5","3","13","5","5","3","13","4","17","17",0,0.00123296335183493,0,"0"
"371830537261016","5","5","3","13","5","5","3","13","5","18","18",0,0.00059778795649663,0,"0"
"371830537252008","3","5","2","10","3","5","2","10","3","13","13",137,0.0229320771026027,5974.16445911266,"38"
"371830537191002","1","1","1","3","3","1","1","5","1","4","6",359,0.0498796542988032,7197.32333847818,"115"
"371830520012011","3","4","5","12","4","5","5","14","3","15","17",17,0.0123268225061168,1379.10641542573,"9"
"371830540111012","1","4","3","8","1","4","3","8","3","11","11",56,0.0211600161523447,2646.50081535003,"21"
"371830537122003","2","1","2","5","2","1","2","5","3","8","8",63,0.0344746853618898,1827.42784564014,"23"
"371830537071015","2","2","2","6","2","2","2","6","3","9","9",416,0.0765252936180495,5436.11112524867,"235"
"371830537251008","2","5","2","9","2","5","2","9","3","12","12",168,0.0146790738733437,11444.8637188943,"113"
"371830540121006","1","4","3","8","1","4","3","8","3","11","11",104,0.0375280882343143,2771.25760711963,"42"
"371830537093010","1","5","1","7","1","5","1","7","2","9","9",632,0.173218131039238,3648.57879604323,"237"
"371830541042024","5","5","3","13","5","5","3","13","5","18","18",365,0.0547507169909651,6666.57936297404,"121"
"371830525051011","5","5","3","13","5","5","4","14","5","18","19",0,0.000502382872430159,0,"0"
"371830541062002","5","3","3","11","5","4","4","13","3","14","16",0,0.601766748086434,0,"0"
"371830537131002","4","2","2","8","4","2","2","8","5","13","13",93,0.0181515835863165,5123.51991537024,"31"
"371830537131004","2","2","3","7","2","2","3","7","4","11","11",0,0.00127727257768013,0,"0"
"371830545003015","1","2","3","6","1","2","3","6","3","9","9",38,0.00688495095391409,5519.28405218298,"25"
"371830530081051","1","4","2","7","1","4","2","7","3","10","10",504,0.0713406923561324,7064.69173980026,"216"
"371830501001005","5","5","5","15","5","5","5","15","4","19","19",205,0.00270121159674479,75891.8702433545,"133"
"371830517002007","4","4","4","12","5","5","5","15","5","17","20",0,0.00809867192044895,0,"0"
"371830507003006","5","4","5","14","5","4","5","14","3","17","17",342,0.0789067332401157,4334.23088191071,"112"
"371830523011000","5","5","4","14","5","5","4","14","5","19","19",125,0.0193557712902164,6458.02216433413,"75"
"371830521021036","2","3","4","9","2","4","4","10","3","12","13",0,0.0289181744814044,0,"0"
"371830528033024","2","2","4","8","2","3","4","9","3","11","12",356,0.0239473164240707,14865.9663444446,"94"
"371830501001043","5","5","5","15","5","5","5","15","4","19","19",2,0.00806272649787137,248.055046953164,"1"
"371830540082009","3","3","3","9","3","3","3","9","2","11","11",34,0.00327573363120171,10379.3543150598,"15"
"371830508002012","5","5","5","15","5","5","5","15","5","20","20",0,0.011360741881229,0,"0"
"371830516002008","3","4","4","11","3","4","5","12","3","14","15",23,0.00885459191832626,2597.52230392427,"11"
"371830530081038","2","4","2","8","2","4","2","8","3","11","11",197,0.00927454499222509,21240.9342091872,"90"
"371830523023002","3","5","3","11","5","5","4","14","3","14","17",51,0.00281656654995434,18107.1524835182,"21"
"371830541061006","2","1","1","4","2","2","2","6","3","7","9",178,0.0226544977830043,7857.15939081811,"58"
"371830525031010","2","5","2","9","2","5","2","9","3","12","12",120,0.00471091245974513,25472.7722124754,"106"
"371830540141042","2","4","2","8","2","5","2","9","3","11","12",0,0.0139879844670499,0,"0"
"371830540182004","1","2","3","6","1","2","3","6","2","8","8",21,0.0228299894075832,919.842739525085,"7"
"371830540081000","3","3","3","9","3","4","3","10","2","11","12",259,0.0678867515231002,3815.17739749071,"105"
"371830511021014","5","5","5","15","5","5","5","15","4","19","19",0,0.00725803017766104,0,"0"
"371830541132013","3","1","1","5","3","2","1","6","3","8","9",113,0.73450383463058,153.845350660196,"45"
"371830527073041","1","4","3","8","1","4","4","9","3","11","12",0,0.0031129012555863,0,"0"
"371830542071073","2","4","1","7","2","4","1","7","3","10","10",20,0.00646826452810136,3092.01949195337,"7"
"371830520012012","4","4","5","13","4","4","5","13","3","16","16",0,0.00952131138189391,0,"0"
"371830540151001","2","3","2","7","2","4","3","9","2","9","11",0,0.104363475742083,0,"0"
"371830540142000","4","3","2","9","4","4","2","10","3","12","13",522,0.162754613302371,3207.28235844358,"174"
"371830541043001","1","2","2","5","3","2","2","7","2","7","9",214,0.0250588409836321,8539.90015499041,"76"
"371830540162012","3","5","3","11","3","5","3","11","2","13","13",16,0.00239696115428789,6675.11860648132,"6"
"371830537072001","5","2","3","10","5","3","4","12","5","15","17",48,0.00968311318449982,4957.08343849948,"21"
"371830540151037","5","4","3","12","5","4","3","12","2","14","14",120,0.0148265364480044,8093.59626375526,"35"
"371830540132018","2","5","1","8","2","5","2","9","4","12","13",0,0.000233221049867547,0,"0"
"371830540151044","4","3","3","10","4","4","3","11","2","12","13",0,0.0058915122124934,0,"0"
"371830540134032","1","4","1","6","1","4","1","6","5","11","11",32,0.00407593673069117,7850.95601682063,"19"
"371830540132038","1","4","1","6","1","5","2","8","5","11","13",37,0.0103466764499819,3576.02754651372,"10"
"371830540131005","2","5","2","9","2","5","2","9","3","12","12",73,0.0265865732664443,2745.74685757398,"28"
"371830540132007","1","4","1","6","1","5","2","8","5","11","13",207,0.0429015858601249,4824.9964622496,"59"
"371830537093002","4","5","2","11","4","5","2","11","2","13","13",8,0.0708502001666886,112.91428931998,"4"
"371830527012023","3","3","4","10","3","3","4","10","3","13","13",0,0.0449589022228009,0,"0"
"371830541042001","2","2","1","5","2","2","2","6","3","8","9",107,0.0982287335241076,1089.29430484553,"32"
"371830536102028","3","5","1","9","3","5","2","10","1","10","11",0,0.0100956363977617,0,"0"
"371830537112013","4","5","2","11","4","5","2","11","3","14","14",147,0.0644436075308303,2281.06410600421,"56"
"371830540171021","2","4","3","9","2","4","3","9","2","11","11",49,0.0031301592460427,15654.1556350362,"20"
"371830540081005","4","4","3","11","4","4","3","11","2","13","13",360,0.0822054833303192,4379.26991504257,"135"
"371830540151025","1","3","2","6","1","3","2","6","3","9","9",0,0.00538633714906844,0,"0"
"371830540162003","3","4","2","9","3","5","2","10","3","12","13",0,0.0232287175494172,0,"0"
"371830540163001","3","5","3","11","3","5","3","11","5","16","16",512,0.15057538190567,3400.2902301835,"181"
"371830540163000","5","5","4","14","5","5","4","14","5","19","19",233,0.0387846054919098,6007.53822411838,"80"
"371830540181001","2","2","2","6","2","3","3","8","2","8","10",0,0.00352712991530567,0,"0"
"371830526012014","3","3","4","10","3","4","5","12","4","14","16",40,0.013852227514371,2887.62222238278,"20"
"371830537141002","2","2","3","7","2","2","3","7","3","10","10",665,0.146360194804201,4543.58509763963,"283"
"371830524093000","5","5","5","15","5","5","5","15","5","20","20",0,0.0623884473749765,0,"0"
"371830523021004","4","5","5","14","4","5","5","14","5","19","19",7,0.00321654689558301,2176.24683464509,"4"
"371830510001013","4","5","5","14","4","5","5","14","4","18","18",110,0.027164822092789,4049.35469940736,"89"
"371830540131009","2","5","2","9","2","5","2","9","4","13","13",99,0.0329795074811567,3001.864113846,"27"
"371830523013001","3","5","4","12","3","5","4","12","5","17","17",215,0.00457445926572991,47000.0906141404,"73"
"371830515011033","5","5","4","14","5","5","5","15","5","19","20",0,0.000900614312107614,0,"0"
"371830528064060","1","1","1","3","1","2","1","4","4","7","8",202,0.017852803094939,11314.7497861142,"71"
"371830540162018","2","4","2","8","2","4","3","9","2","10","11",34,0.00192968519161126,17619.4542756533,"17"
"371830523023005","2","3","2","7","2","3","2","7","2","9","9",1461,0.134515402954163,10861.2097047195,"500"
"371830530081035","2","4","2","8","2","4","2","8","3","11","11",73,0.00461683239434945,15811.7067644355,"63"
"371830523013030","2","5","3","10","3","5","3","11","3","13","14",36,0.00184695388841043,19491.5532141321,"12"
"371830524061003","1","4","2","7","4","4","3","11","3","10","14",663,0.178254409877569,3719.40307370443,"284"
"371830526032005","1","1","3","5","1","1","4","6","3","8","9",0,0.00491280528266325,0,"0"
"371830527013019","5","4","5","14","5","4","5","14","5","19","19",3,0.0336398186923084,89.1800288057421,"1"
"371830518002000","5","4","5","14","5","5","5","15","4","18","19",131,0.0394033008365805,3324.59456996518,"56"
"371830523021019","3","5","4","12","3","5","5","13","4","16","17",0,0.029091968993793,0,"0"
"371830518002020","4","4","5","13","4","4","5","13","4","17","17",62,0.0110360274868028,5617.96353571441,"27"
"371830514005011","5","5","5","15","5","5","5","15","3","18","18",50,0.00892103808920588,5604.72890038415,"17"
"371830526031015","4","3","4","11","4","3","5","12","5","16","17",47,0.0155110670447772,3030.09456824091,"16"
"371830517002008","4","4","4","12","5","4","5","14","4","16","18",48,0.0110947827362593,4326.35781529361,"18"
"371830521011011","2","2","3","7","2","2","4","8","2","9","10",35,0.115553508651848,302.889980653481,"11"
"371830524011006","2","5","2","9","2","5","2","9","3","12","12",0,0.00629222949981696,0,"0"
"371830518002003","5","4","5","14","5","5","5","15","5","19","20",21,0.00291547491391301,7202.94312936304,"5"
"371830504002013","5","5","5","15","5","5","5","15","4","19","19",357,0.0230831433198902,15465.8312801091,"1"
"371830521021040","3","3","3","9","3","4","4","11","4","13","15",664,0.0942736742533571,7043.32365592884,"203"
"371830521014006","3","4","5","12","3","4","5","12","4","16","16",174,0.106251294463506,1637.62710730798,"59"
"371830528064008","1","1","1","3","1","1","1","3","4","7","7",62,0.0956780649264096,648.006416598069,"23"
"371830523021044","1","3","1","5","1","3","1","5","2","7","7",0,0.0144745111508453,0,"0"
"371830530081046","2","4","2","8","2","4","2","8","3","11","11",84,0.0128522660502235,6535.81241407147,"26"
"371830516005012","4","4","5","13","5","5","5","15","3","16","18",0,0.00389231619188101,0,"0"
"371830503002002","5","5","5","15","5","5","5","15","3","18","18",0,0.00593082753074368,0,"0"
"371830503002000","5","5","5","15","5","5","5","15","3","18","18",2,0.00661775914179733,302.217103576365,"2"
"371830524081002","4","4","4","12","4","5","5","14","4","16","18",277,0.0433536725749779,6389.30876088855,"84"
"371830501001028","5","5","5","15","5","5","5","15","4","19","19",5,0.00845525206707856,591.348425846231,"2"
"371830501001070","5","5","5","15","5","5","5","15","5","20","20",2,0.00836668497739522,239.043301546971,"1"
"371830510002014","5","5","5","15","5","5","5","15","5","20","20",35,0.00519284848890133,6740.03874266801,"22"
"371830523023017","2","5","3","10","2","5","3","10","3","13","13",43,0.0165777965790808,2593.83083842764,"15"
"371830528071001","1","1","1","3","1","1","1","3","5","8","8",5,0.4966262950711,10.067932466774,"2"
"371830528072065","3","1","1","5","4","3","2","9","2","7","11",34,0.00913989051331536,3719.95703345324,"12"
"371830515011035","4","3","4","11","4","3","5","12","4","15","16",31,0.0115144416077918,2692.27124127517,"14"
"371830515011031","4","3","4","11","4","3","5","12","5","16","17",40,0.0133635426528555,2993.21826846961,"16"
"371830537113000","4","5","3","12","4","5","3","12","5","17","17",42,0.0112828775171976,3722.45466070004,"16"
"371830537121011","5","3","3","11","5","3","3","11","5","16","16",2,0.00195750582462622,1021.70832640148,"1"
"371830537241077","2","5","2","9","2","5","2","9","3","12","12",79,0.012379593928516,6381.46941298503,"25"
"371830537211039","3","1","2","6","3","2","2","7","3","9","10",15,0.0116984576563393,1282.2203097749,"5"
"371830523021032","5","5","5","15","5","5","5","15","4","19","19",0,0.00487932423312673,0,"0"
"371830519003013","1","2","4","7","2","3","4","9","4","11","13",0,0.00095536096293824,0,"0"
"371830520012000","2","3","4","9","4","4","5","13","4","13","17",139,0.0978974700097364,1419.85283160204,"0"
"371830541063031","3","3","2","8","3","3","2","8","4","12","12",0,0.0182712137898147,0,"0"
"371830541052033","1","3","3","7","1","4","3","8","3","10","11",0,0.00465801098329272,0,"0"
"371830541103040","1","1","1","3","3","2","2","7","3","6","10",128,0.533991585204092,239.704151800591,"49"
"371830541044012","1","2","3","6","5","3","3","11","2","8","13",175,0.0260662254362569,6713.66862946651,"58"
"371830530081057","4","5","3","12","4","5","3","12","4","16","16",79,0.0639139612567057,1236.03667253078,"35"
"371830536101027","1","1","1","3","1","1","1","3","1","4","4",0,0.0022997053287533,0,"0"
"371830537211023","3","1","2","6","3","1","2","6","3","9","9",0,0.000442893588642736,0,"0"
"371830537241028","2","5","2","9","2","5","2","9","2","11","11",109,0.0160962445790309,6771.76589016285,"49"
"371830540134003","3","5","3","11","3","5","3","11","5","16","16",0,0.00162069287907391,0,"0"
"371830501001055","5","5","5","15","5","5","5","15","5","20","20",0,0.0125553433675078,0,"0"
"371830537071022","5","3","3","11","5","3","4","12","4","15","16",112,0.103100006969967,1086.3238838832,"49"
"371830537151010","5","5","4","14","5","5","4","14","5","19","19",79,0.0600514116270358,1315.53943295537,"50"
"371830525051026","5","3","4","12","5","3","4","12","5","17","17",13,0.00664095931451793,1957.54850832777,"4"
"371830537262019","3","5","2","10","3","5","2","10","3","13","13",0,6.97952073293705e-05,0,"0"
"371830525072021","1","2","2","5","1","2","2","5","4","9","9",30,0.016243798073385,1846.85871275106,"14"
"371830505003005","4","4","5","13","4","4","5","13","5","18","18",0,0.0171330848307511,0,"0"
"371830527062016","2","3","4","9","2","3","4","9","3","12","12",0,0.123606129882132,0,"0"
"371830505002001","5","5","5","15","5","5","5","15","4","19","19",380,0.0151243228339309,25125.0918254325,"114"
"371830519003012","2","3","4","9","3","3","5","11","5","14","16",0,0.0191919444833483,0,"0"
"371830540141044","1","3","1","5","2","4","2","8","3","8","11",0,0.00233039376552964,0,"0"
"371830528061024","5","5","4","14","5","5","4","14","5","19","19",0,0.027374127714294,0,"0"
"371830541062021","4","4","4","12","4","5","4","13","3","15","16",3,0.00408854295548093,733.757730483992,"1"
"371830541044018","2","3","2","7","3","3","3","9","3","10","12",122,0.0175431432802691,6954.28396444864,"54"
"371830527063006","2","2","2","6","2","2","3","7","3","9","10",118,0.0792978116220813,1488.06124136649,"48"
"371830536101005","1","5","1","7","1","5","1","7","1","8","8",0,0.0040595922680838,0,"0"
"371830528033036","3","2","4","9","3","2","4","9","3","12","12",70,0.0108834317870728,6431.79480236604,"27"
"371830528072007","3","1","2","6","3","3","2","8","3","9","11",103,0.0212035232214796,4857.68326914929,"36"
"371830537251009","3","5","2","10","3","5","2","10","4","14","14",127,0.0377041079032855,3368.33324171909,"44"
"371830537131014","4","5","3","12","4","5","3","12","5","17","17",16,0.00292593783695105,5468.33216958316,"11"
"371830537171039","1","5","1","7","1","5","1","7","1","8","8",0,0.00746874735516143,0,"0"
"371830537241048","2","5","2","9","2","5","2","9","2","11","11",0,0.0469572211135758,0,"0"
"371830537262000","2","5","2","9","2","5","2","9","4","13","13",268,0.0580300477719408,4618.29707694271,"118"
"371830537251013","3","5","2","10","3","5","2","10","4","14","14",37,0.00549940430726551,6728.00142210269,"20"
"371830537241001","1","5","1","7","1","5","1","7","2","9","9",237,0.0380230016753228,6233.06918332581,"97"
"371830537121005","3","1","2","6","3","1","2","6","3","9","9",1,0.00330451472482618,302.616294152722,"1"
"371830540141021","1","2","1","4","1","3","2","6","4","8","10",48,0.00408537548524492,11749.2260315755,"16"
"371830542071113","2","5","1","8","2","5","1","8","4","12","12",108,0.0109928962003645,9824.52649706811,"32"
"371830540151009","4","4","3","11","4","4","4","12","2","13","14",191,0.212096881367241,900.531864347818,"64"
"371830537162011","4","4","4","12","4","4","4","12","4","16","16",63,0.0219630436299349,2868.45489457268,"28"
"371830540072006","1","2","3","6","2","2","3","7","4","10","11",23,0.0180246683935991,1276.02902298983,"9"
"371830537112003","3","5","2","10","3","5","2","10","3","13","13",56,0.0414966089145619,1349.50786256533,"21"
"371830540081003","4","3","3","10","4","4","3","11","2","12","13",36,0.0068998094922422,5217.53535955979,"15"
"371830540061004","4","3","3","10","4","3","4","11","5","15","16",0,0.0090524073593908,0,"0"
"371830537131006","2","2","2","6","2","2","3","7","4","10","11",0,0.0232714966795118,0,"0"
"371830537113010","5","5","3","13","5","5","3","13","4","17","17",71,0.0117078403286015,6064.31229050431,"18"
"371830537252006","2","5","1","8","2","5","1","8","2","10","10",7,0.00492920543335372,1420.10717440059,"2"
"371830537252019","2","5","1","8","2","5","1","8","2","10","10",42,0.0851377805180518,493.318004585458,"14"
"371830540151007","2","4","3","9","2","5","3","10","2","11","12",0,0.213009421234436,0,"0"
"371830528064023","2","1","1","4","3","3","2","8","3","7","11",754,0.25180795041764,2994.34548730269,"232"
"371830521022002","4","2","4","10","4","2","4","10","3","13","13",52,0.00606172364889103,8578.41812196654,"19"
"371830537111024","2","5","1","8","2","5","1","8","2","10","10",84,0.0121930245710907,6889.18483762932,"42"
"371830523013004","3","5","3","11","3","5","4","12","5","16","17",446,0.0671483763231833,6642.00721478974,"255"
"371830527013000","4","3","4","11","4","3","5","12","3","14","15",129,0.0259688200275885,4967.49562987283,"86"
"371830540171023","2","4","3","9","2","4","3","9","2","11","11",23,0.00390436889035003,5890.83681535483,"10"
"371830526022000","5","3","4","12","5","3","4","12","3","15","15",49,0.0186704479818664,2624.46836024455,"21"
"371830526032009","4","3","4","11","4","3","5","12","4","15","16",82,0.0138075286194967,5938.78906643823,"29"
"371830517001015","5","4","5","14","5","4","5","14","4","18","18",48,0.00966775079626153,4964.9604144287,"14"
"371830524071005","3","5","4","12","4","5","4","13","3","15","16",165,0.16311344814001,1011.56588792342,"74"
"371830537113005","4","5","3","12","4","5","3","12","4","16","16",439,0.0154072961776614,28492.9941592539,"234"
"371830537241075","2","5","2","9","2","5","2","9","3","12","12",0,0.00160733033668503,0,"0"
"371830537241004","1","5","1","7","1","5","2","8","2","9","10",622,0.0798268932103142,7791.86029902556,"297"
"371830527012014","3","3","4","10","3","3","4","10","2","12","12",0,0.000371490728387806,0,"0"
"371830540171039","2","3","2","7","3","4","3","10","2","9","12",2,0.076132342824693,26.2700440548023,"1"
"371830541062035","4","3","4","11","4","4","5","13","3","14","16",250,0.0380441529258543,6571.31203544562,"86"
"371830540043007","2","3","4","9","2","4","4","10","2","11","12",371,0.0354735254084295,10458.5037920093,"139"
"371830527011010","4","3","4","11","4","3","4","11","2","13","13",115,0.0275635577390716,4172.17548941392,"45"
"371830540182013","1","3","2","6","1","4","3","8","2","8","10",0,0.0223916352298896,0,"0"
"371830527043025","5","3","4","12","5","3","4","12","2","14","14",114,0.0196846536275173,5791.31348496976,"35"
"371830537241016","1","5","2","8","1","5","2","8","2","10","10",172,0.025176599133821,6831.74081955112,"48"
"371830537132018","4","3","3","10","4","3","3","10","4","14","14",101,0.00638201069501015,15825.7334289596,"42"
"371830537251018","2","5","2","9","2","5","2","9","4","13","13",70,0.0146540849186398,4776.82505517358,"24"
"371830537251022","4","5","3","12","4","5","3","12","5","17","17",122,0.011568680470538,10545.714380365,"60"
"371830540042005","4","3","4","11","4","3","4","11","2","13","13",54,0.0131921621546199,4093.3396184104,"24"
"371830540181015","3","3","4","10","3","4","4","11","2","12","13",4,0.1302246759707,30.7161447719785,"2"
"371830523013019","3","5","3","11","3","5","3","11","4","15","15",0,0.0172908611613538,0,"0"
"371830523013006","2","5","3","10","2","5","4","11","5","15","16",13,0.00317778998581229,4090.89337496827,"6"
"371830523023023","2","5","3","10","4","5","3","12","3","13","15",20,0.00207960491951205,9617.21133295486,"8"
"371830537171025","1","5","1","7","2","5","1","8","1","8","9",49,0.00220688801830809,22203.2108532475,"30"
"371830537161006","4","5","4","13","4","5","4","13","5","18","18",229,0.0525461706800388,4358.07209233978,"171"
"371830536102076","3","5","1","9","3","5","2","10","1","10","11",0,0.00410441856396643,0,"0"
"371830540071002","2","2","3","7","2","2","3","7","5","12","12",87,0.0173379075040214,5017.90657147185,"50"
"371830537162000","5","4","4","13","5","4","4","13","5","18","18",675,0.261827247727019,2578.03573103955,"300"
"371830537223003","3","2","2","7","3","2","2","7","3","10","10",177,0.0592103673297586,2989.34136000608,"65"
"371830540013000","4","3","4","11","4","3","4","11","3","14","14",1305,0.13634659071569,9571.19641312618,"601"
"371839801001003","1","5","1","7","1","5","1","7","1","8","8",0,0.164611079560319,0,"0"
"371839801001002","1","5","1","7","1","5","2","8","1","8","9",0,0.00581191918994388,0,"0"
"371839801001019","1","5","1","7","1","5","1","7","1","8","8",0,0.00817394927516495,0,"0"
"371830537112004","2","5","2","9","2","5","2","9","3","12","12",58,0.0358708125068282,1616.9134721707,"19"
"371830537211046","4","5","1","10","4","5","2","11","2","12","13",90,0.111937129729873,804.022760072443,"35"
"371830537241037","2","5","2","9","2","5","2","9","2","11","11",63,0.0096150099100459,6552.25533716577,"29"
"371830537152011","3","3","3","9","3","3","3","9","4","13","13",155,0.0384931328671802,4026.69225533875,"56"
"371830537252021","2","5","2","9","2","5","2","9","3","12","12",130,0.0303977477650576,4276.63263096866,"37"
"371830542071045","1","2","1","4","1","2","1","4","2","6","6",269,0.0672915653714412,3997.52923735914,"84"
"371830542071037","2","4","1","7","2","4","1","7","3","10","10",71,0.00629036487450766,11287.1035967619,"34"
"371830541053026","4","3","2","9","4","3","2","9","5","14","14",44,0.00339533802876389,12958.9453619199,"17"
"371830541131017","1","1","1","3","4","3","2","9","5","8","14",47,0.00567995192971779,8274.71791690589,"15"
"371830541052025","2","3","2","7","2","3","3","8","3","10","11",89,0.0541482114820639,1643.6369284234,"35"
"371830527072026","3","3","3","9","3","3","4","10","2","11","12",107,0.0253759251374971,4216.59503723432,"37"
"371830528062011","3","2","3","8","3","2","3","8","3","11","11",130,0.0335287139625254,3877.27367489548,"36"
"371830527062002","4","2","4","10","4","2","4","10","3","13","13",241,0.042843865239485,5625.07604421027,"119"
"371830515012020","4","2","4","10","4","3","5","12","3","13","15",100,0.0288873077565485,3461.72792711466,"31"
"371830528061017","1","1","2","4","3","2","3","8","5","9","13",0,0.00521736057573004,0,"0"
"371830536102077","3","1","1","5","3","1","1","5","1","6","6",0,0.0502144209504271,0,"0"
"371830537071009","3","3","3","9","3","3","3","9","3","12","12",67,0.0301748528803457,2220.39193581753,"29"
"371830525061019","3","2","3","8","3","2","3","8","4","12","12",17,0.0176283697733643,964.354629415949,"7"
"371830515011009","5","3","4","12","5","3","5","13","4","16","17",0,0.00537586563666246,0,"0"
"371830515011039","3","2","4","9","3","3","5","11","4","13","15",86,0.0245335735819362,3505.40045512655,"35"
"371830515011024","5","3","4","12","5","3","5","13","4","16","17",44,0.0152947746617355,2876.79949349495,"17"
"371830528033004","1","2","3","6","4","3","4","11","3","9","14",63,0.00898121361396104,7014.64219736053,"19"
"371830521012009","5","4","5","14","5","4","5","14","3","17","17",97,0.0167323733141414,5797.14534088361,"31"
"371830504001033","5","4","5","14","5","4","5","14","3","17","17",52,0.0102061399895956,5094.97224739325,"27"
"371830504001005","4","4","5","13","5","5","5","15","3","16","18",0,0.00530688071145601,0,"0"
"371830504001028","5","5","5","15","5","5","5","15","4","19","19",0,0.00291085372283061,0,"0"
"371830523021013","4","5","4","13","4","5","5","14","4","17","18",0,0.0100907699976173,0,"0"
"371830515011030","4","3","4","11","4","3","5","12","3","14","15",130,0.0378170439444712,3437.6034306353,"63"
"371830528062025","4","3","4","11","4","4","4","12","3","14","15",216,0.0810284727398562,2665.7296219006,"79"
"371830537093031","1","5","1","7","1","5","1","7","2","9","9",0,0.00285281911759121,0,"0"
"371830537142030","3","3","3","9","3","3","3","9","4","13","13",187,0.00716121082104221,26112.9025067279,"79"
"371830537091015","1","1","1","3","1","1","1","3","3","6","6",0,0.218348354918236,0,"0"
"371830537252027","1","5","2","8","1","5","2","8","3","11","11",348,0.0765174080009862,4547.98468860203,"197"
"371830520011010","3","2","3","8","5","3","5","13","3","11","16",0,0.000549389419740344,0,"0"
"371830501001030","4","5","5","14","5","5","5","15","4","18","19",3,0.0127380190234012,235.515427829764,"2"
"371830515012024","4","4","4","12","4","4","5","13","3","15","16",31,0.00748701169868564,4140.50374803636,"8"
"371830524062014","1","4","2","7","5","4","3","12","3","10","15",178,0.010864791496363,16383.1952099206,"92"
"371830530081001","1","3","2","6","4","4","2","10","3","9","13",289,0.0558346204173249,5176.00008453405,"115"
"371830511023003","5","5","5","15","5","5","5","15","5","20","20",15,0.0514121268166549,291.759958764063,"4"
"371830530081062","2","4","2","8","2","4","2","8","3","11","11",164,0.00894195418831826,18340.5099764713,"112"
"371830523021012","3","5","4","12","3","5","4","12","4","16","16",20,0.000654957074219389,30536.3523614689,"9"
"371830527072015","4","5","3","12","4","5","3","12","2","14","14",39,0.0102194155515782,3816.26520647526,"26"
"371830525061014","5","2","2","9","5","2","3","10","3","12","13",38,0.0197239567553536,1926.59112323828,"15"
"371830528062051","4","2","2","8","4","3","3","10","3","11","13",43,0.00544086867732961,7903.14976341324,"16"
"371830541061020","1","2","3","6","1","2","4","7","3","9","10",0,0.00868285360078178,0,"0"
"371830525043036","5","3","4","12","5","3","5","13","5","17","18",0,0.00267611880722894,0,"0"
"371830541101006","2","1","1","4","2","1","1","4","3","7","7",84,0.0203579947684352,4126.14311750591,"29"
"371830537093020","1","5","1","7","1","5","1","7","3","10","10",25,0.0192141898677255,1301.12173201708,"13"
"371830540011001","4","3","4","11","4","3","4","11","3","14","14",41,0.00606980386509874,6754.74873838168,"28"
"371830537221007","2","2","2","6","2","2","2","6","3","9","9",108,0.00994276131057413,10862.1736584526,"59"
"371830527061039","2","3","4","9","3","3","5","11","5","14","16",0,0.000201322496351746,0,"0"
"371830538082014","2","1","2","5","2","1","3","6","3","8","9",83,0.0371076018211904,2236.73845590859,"28"
"371830525043001","3","2","3","8","3","2","3","8","5","13","13",260,0.0542319806997438,4794.21914238195,"207"
"371830525043000","4","3","4","11","4","3","4","11","5","16","16",0,0.00876686506901025,0,"0"
"371830525041017","3","5","4","12","3","5","5","13","5","17","18",0,0.00585406713626205,0,"0"
"371830541132010","1","1","1","3","1","1","1","3","2","5","5",0,0.00930039503773632,0,"0"
"371830507003002","5","4","5","14","5","4","5","14","3","17","17",20,0.00524771243106317,3811.18444707689,"8"
"371830524011066","1","5","2","8","1","5","3","9","4","12","13",591,0.106917519205445,5527.62544802762,"359"
"371830524011017","1","5","2","8","1","5","2","8","4","12","12",0,0.0226892821456708,0,"0"
"371830524011034","1","5","2","8","1","5","3","9","4","12","13",2,0.104784832427504,19.0867318644014,"1"
"371830509001029","5","5","5","15","5","5","5","15","5","20","20",0,0.000187792301183386,0,"0"
"371830536102011","3","5","1","9","3","5","2","10","1","10","11",50,0.00300432867043375,16642.6531464619,"38"
"371830536101010","1","5","1","7","1","5","1","7","1","8","8",0,0.0019499321230273,0,"0"
"371830540141043","2","4","2","8","2","5","3","10","3","11","13",0,0.00336604875512203,0,"0"
"371830527011020","5","3","4","12","5","3","4","12","2","14","14",865,0.0880258704892968,9826.65658620412,"354"
"371830537161007","4","4","4","12","4","4","4","12","4","16","16",0,0.024274536625086,0,"0"
"371830537072000","4","2","3","9","4","2","4","10","4","13","14",339,0.101391081206549,3343.48934803649,"141"
"371830537224002","4","1","2","7","4","1","3","8","3","10","11",91,0.02190138360975,4154.98863548917,"38"
"371830540141024","1","2","1","4","1","3","2","6","4","8","10",85,0.00409117690872786,20776.417616815,"36"
"371830540171001","4","5","3","12","4","5","3","12","2","14","14",0,0.00492911468175088,0,"0"
"371830528072023","3","1","1","5","3","2","1","6","2","7","8",33,0.00599296570718262,5506.45567026176,"9"
"371830537093032","1","5","1","7","1","5","1","7","2","9","9",74,0.177160185451301,417.701075506842,"34"
"371830524041016","5","5","4","14","5","5","4","14","4","18","18",55,0.0140043509307993,3927.35088343441,"20"
"371830514004009","5","5","5","15","5","5","5","15","5","20","20",7,0.0112608604239602,621.622126236982,"4"
"371830540161005","3","5","2","10","3","5","3","11","4","14","15",360,0.0511538879952208,7037.58822855525,"120"
"371830540151020","3","4","3","10","3","5","3","11","2","12","13",0,0.00657318164379217,0,"0"
"371830541055010","1","2","2","5","1","2","2","5","4","9","9",140,0.158058010822244,885.750739691692,"54"
"371830541055011","1","2","2","5","1","2","2","5","3","8","8",36,0.0292666282858334,1230.06995026571,"16"
"371830540141008","1","3","1","5","2","4","2","8","3","8","11",311,0.02297061735392,13539.0353340646,"144"
"371830527073040","1","2","2","5","1","2","3","6","3","8","9",0,0.0759453924517839,0,"0"
"371830537113001","4","5","3","12","4","5","3","12","5","17","17",29,0.00698961884422237,4149.01021734131,"10"
"371830540071001","1","3","3","7","1","3","3","7","3","10","10",910,0.415014831273011,2192.69272186895,"439"
"371830537223002","4","2","2","8","4","2","2","8","2","10","10",175,0.055833114580129,3134.34063845477,"82"
"371830537071028","3","3","3","9","3","3","3","9","3","12","12",60,0.0237741940678443,2523.74485666173,"28"
"371830540011004","5","3","4","12","5","3","4","12","3","15","15",758,0.267320503330374,2835.54755642222,"350"
"371830525072022","1","1","2","4","1","1","2","4","5","9","9",46,0.0269195027662598,1708.79827905496,"18"
"371830525071017","3","3","3","9","3","3","4","10","5","14","15",0,0.0308621344950025,0,"0"
"371830520021004","3","4","4","11","4","5","5","14","4","15","18",13,0.0059500317544472,2184.86228922787,"6"
"371830541132037","5","3","2","10","5","4","2","11","5","15","16",225,0.0726828635593788,3095.640278622,"81"
"371830528062043","1","1","2","4","5","3","3","11","5","9","16",84,0.0101404674596234,8283.64178815869,"24"
"371830541062044","3","1","1","5","3","2","2","7","5","10","12",29,0.0179282413133557,1617.5596642821,"17"
"371830542091040","2","1","1","4","2","1","1","4","3","7","7",1547,0.256678967995971,6026.98387046765,"629"
"371830526012024","3","3","4","10","3","3","5","11","3","13","14",0,0.00623028312726225,0,"0"
"371830515011020","3","3","4","10","4","3","5","12","4","14","16",447,0.101177736020168,4417.96799951027,"292"
"371830503001028","5","5","5","15","5","5","5","15","3","18","18",1,0.000440766062167995,2268.77721728688,"1"
"371830526021020","3","2","4","9","3","3","4","10","3","12","13",60,0.0153389095843027,3911.62094477707,"26"
"371830524062024","1","5","2","8","2","5","3","10","3","11","13",0,0.00686716894475279,0,"0"
"371830530081011","1","3","2","6","2","4","2","8","2","8","10",243,0.144485516604561,1681.82947128923,"130"
"371830514005012","5","4","5","14","5","5","5","15","3","17","18",28,0.0066917059202425,4184.28429666935,"12"
"371830541054016","3","4","3","10","3","4","3","10","3","13","13",73,0.00621085275362346,11753.6194941043,"23"
"371830520011008","2","2","3","7","5","3","5","13","3","10","16",0,0.0277837588888241,0,"0"
"371830541102030","1","1","1","3","2","2","1","5","2","5","7",149,0.304138257324193,489.90877146105,"78"
"371830515012003","4","4","4","12","4","4","5","13","3","15","16",50,0.0240899854566385,2075.55127378549,"15"
"371830541063010","5","3","2","10","5","4","3","12","5","15","17",75,0.0089052114191704,8422.03474681648,"25"
"371830537071025","4","3","3","10","4","3","4","11","3","13","14",57,0.0265747385550457,2144.89410241734,"22"
"371830514005016","5","5","5","15","5","5","5","15","3","18","18",40,0.00780906256000799,5122.25375230687,"26"
"371830525051012","5","5","3","13","5","5","4","14","5","18","19",36,0.00609406045252853,5907.39134940202,"27"
"371830542081086","1","4","1","6","1","4","1","6","2","8","8",0,0.0140328739363096,0,"0"
"371830528072036","1","1","2","4","1","2","2","5","3","7","8",0,0.00302459016919225,0,"0"
"371830545002001","4","4","4","12","4","4","5","13","5","17","18",0,0.00532149566254122,0,"0"
"371830528064056","1","1","1","3","1","2","1","4","4","7","8",28,0.0311493759947145,898.894411392097,"8"
"371830527072019","3","3","3","9","3","3","4","10","2","11","12",134,0.0309035036580832,4336.07792445083,"56"
"371830537241085","1","5","2","8","1","5","2","8","3","11","11",196,0.0203363134982977,9637.93167411621,"107"
"371830526022004","4","2","4","10","4","2","4","10","3","13","13",73,0.0319362237399236,2285.80562919662,"32"
"371830536102002","1","5","1","7","1","5","1","7","1","8","8",56,0.421793179952235,132.766489980567,"29"
"371830527071012","2","3","3","8","2","3","3","8","2","10","10",83,0.0104136146073878,7970.33528983457,"29"
"371830537241087","2","5","1","8","2","5","1","8","2","10","10",155,0.016638875830118,9315.53318761084,"43"
"371830526022007","4","3","4","11","4","3","5","12","3","14","15",30,0.00878470820484742,3415.02521204358,"14"
"371830523011006","5","5","4","14","5","5","4","14","5","19","19",0,0.0984504074735258,0,"0"
"371830545004010","2","4","3","9","2","4","3","9","2","11","11",57,0.00692518501421999,8230.82702959672,"27"
"371830545002022","4","4","4","12","4","4","5","13","4","16","17",48,0.0987980256444274,485.839668221218,"13"
"371830536102052","2","5","1","8","2","5","1","8","1","9","9",0,0.0102664255292088,0,"0"
"371830511021004","5","5","5","15","5","5","5","15","4","19","19",0,0.00128830000279837,0,"0"
"371830540132027","1","4","1","6","1","5","2","8","4","10","12",56,0.00524373155042069,10679.4177889422,"21"
"371830540134012","1","4","1","6","1","4","1","6","5","11","11",0,0.00234737549301327,0,"0"
"371830506002004","5","4","5","14","5","4","5","14","3","17","17",32,0.00551614877397487,5801.14882886692,"12"
"371830506002029","5","4","5","14","5","5","5","15","4","18","19",50,0.00708897118732324,7053.20965183381,"17"
"371830540171047","3","5","3","11","3","5","3","11","2","13","13",0,0.000381891546886041,0,"0"
"371830540081009","5","4","3","12","5","4","3","12","2","14","14",33,0.00550459873743007,5994.98738674759,"12"
"371830506002027","5","4","5","14","5","5","5","15","4","18","19",12,0.00336667134059077,3564.35148727476,"4"
"371830507003018","5","4","5","14","5","4","5","14","4","18","18",4,0.00253959958496349,1575.05144656791,"3"
"371830508001004","5","5","5","15","5","5","5","15","5","20","20",32,0.0365211529138404,876.204540297329,"14"
"371830508001017","5","5","5","15","5","5","5","15","5","20","20",64,0.00339031870800698,18877.2813154262,"56"
"371830508003000","5","5","5","15","5","5","5","15","4","19","19",27,0.00853317564460032,3164.12097026097,"18"
"371830526031012","4","3","4","11","4","3","5","12","4","15","16",150,0.0542924058057473,2762.81733649241,"54"
"371830517001006","4","4","4","12","4","4","5","13","5","17","18",148,0.0408094175005798,3626.61388141346,"52"
"371830517002011","4","4","5","13","5","4","5","14","4","17","18",106,0.0214479592196801,4942.19514846602,"35"
"371830537222000","3","2","3","8","3","2","3","8","3","11","11",88,0.0200970437209028,4378.75347350077,"27"
"371830528072074","4","2","2","8","4","5","2","11","2","10","13",77,0.00511142591876398,15064.2895395068,"34"
"371830541062016","4","3","3","10","4","4","3","11","3","13","14",0,0.0310276142216009,0,"0"
"371830527062004","3","2","4","9","3","2","4","9","3","12","12",357,0.00808829939558769,44137.8320138285,"119"
"371830541044008","2","2","3","7","4","3","3","10","2","9","12",28,0.0148357700151502,1887.33041637923,"14"
"371830527071001","2","3","3","8","4","3","3","10","2","10","12",246,0.0327791896867734,7504.76147673848,"90"
"371830516005010","4","4","5","13","5","4","5","14","3","16","17",13,0.0127960035220499,1015.94220239144,"5"
"371830536102008","2","5","1","8","2","5","1","8","1","9","9",807,0.179530505236696,4495.0578116852,"435"
"371830530031001","1","2","2","5","3","2","2","7","2","7","9",0,0.00804665893400199,0,"0"
"371830501001022","5","5","5","15","5","5","5","15","4","19","19",0,0.00468074468902575,0,"0"
"371830541102045","1","1","1","3","2","1","1","4","2","5","6",217,0.0450317843799496,4818.81859641829,"98"
"371830537122001","3","2","2","7","3","2","2","7","3","10","10",36,0.0219082545205846,1643.21625742366,"26"
"371830537181003","1","1","1","3","2","1","1","4","1","4","5",59,0.00891596188876051,6617.345468286,"26"
"371830537181015","1","1","1","3","2","1","1","4","1","4","5",50,0.0134370832789604,3721.04562887463,"25"
"371830512003026","5","5","5","15","5","5","5","15","4","19","19",10,0.00200280323926924,4993.0017107665,"4"
"371830501001091","5","5","5","15","5","5","5","15","5","20","20",2,0.00230691392273986,866.959092095057,"1"
"371830540062001","2","2","3","7","2","2","3","7","3","10","10",245,0.0617474825129106,3967.77309825989,"105"
"371830540013003","4","3","4","11","4","3","4","11","3","14","14",0,0.0070397797031843,0,"0"
"371830540012004","5","3","4","12","5","3","4","12","3","15","15",220,0.0237953137202486,9245.51794468635,"117"
"371830540012009","3","2","3","8","3","3","4","10","3","11","13",0,0.00644993428767528,0,"0"
"371830536101063","4","1","1","6","4","1","1","6","1","7","7",67,0.0107575473890827,6228.18543825284,"21"
"371830520021003","3","4","4","11","4","5","5","14","4","15","18",19,0.00751680949024033,2527.66815823511,"7"
"371830536102020","4","5","1","10","4","5","2","11","1","11","12",196,0.0371061451060625,5282.14395323909,"116"
"371830540143006","1","3","2","6","1","4","3","8","2","8","10",43,0.00476379880096525,9026.40976174041,"17"
"371830537161002","5","5","4","14","5","5","5","15","5","19","20",46,0.0122049860104156,3768.95147284431,"22"
"371830527043012","5","3","4","12","5","3","4","12","2","14","14",103,0.0139617608707502,7377.29294703681,"29"
"371830521014013","4","5","5","14","4","5","5","14","5","19","19",43,0.00852206905070349,5045.72302150619,"19"
"371830519001038","5","4","5","14","5","5","5","15","3","17","18",48,0.0136857137301375,3507.30703173328,"18"
"371830538082008","2","4","3","9","2","4","3","9","5","14","14",86,0.0296468573472962,2900.81336421458,"26"
"371830527013003","5","3","4","12","5","3","5","13","2","14","15",183,0.00834347798950965,21933.299306367,"74"
"371830527011003","3","2","4","9","3","3","4","10","2","11","12",91,0.0271801615699665,3348.03013461675,"38"
"371830519002022","4","4","5","13","4","5","5","14","4","17","18",57,0.0105143026059618,5421.18694279161,"27"
"371830519001008","4","4","4","12","5","4","5","14","4","16","18",111,0.0190564888918734,5824.78758966641,"41"
"371830515012025","3","2","3","8","3","2","4","9","4","12","13",174,0.0604290612822132,2879.4092826859,"74"
"371830515012007","4","3","4","11","4","3","5","12","4","15","16",47,0.0116855816475772,4022.05054206647,"14"
"371830515011028","4","2","4","10","4","3","4","11","4","14","15",199,0.0651561709328155,3054.2003489615,"76"
"371830515012017","3","2","4","9","3","3","5","11","4","13","15",54,0.0229015598887931,2357.91798734308,"21"
"371830515011016","4","3","4","11","4","3","5","12","5","16","17",0,0.00488666961306222,0,"0"
"371830515022012","4","4","4","12","4","5","5","14","5","17","19",86,0.0239819536697615,3586.02977823429,"32"
"371830519001020","5","4","5","14","5","4","5","14","3","17","17",37,0.0339128974076494,1091.0303403228,"17"
"371830519003004","5","2","4","11","5","3","5","13","5","16","18",72,0.0160647874833387,4481.85200549173,"29"
"371830528064050","2","1","1","4","3","3","1","7","3","7","10",39,0.148528110155059,262.576558466174,"17"
"371830514004005","5","5","5","15","5","5","5","15","5","20","20",0,0.00258054450292678,0,"0"
"371830514004002","5","5","5","15","5","5","5","15","5","20","20",55,0.0125823531109745,4371.20143703711,"32"
"371830537181004","1","1","1","3","5","1","2","8","1","4","9",258,0.0376806180345404,6847.02145181114,"91"
"371830537241034","2","5","2","9","2","5","2","9","2","11","11",27,0.00317032703732525,8516.47154445602,"19"
"371830537171028","1","5","1","7","2","5","1","8","1","8","9",107,0.00560285183546765,19097.4173763903,"73"
"371830540121009","1","4","3","8","1","4","4","9","3","11","12",41,0.0137083731585165,2990.87276994121,"20"
"371830523023030","4","5","4","13","4","5","4","13","3","16","16",0,0.0149692207211667,0,"0"
"371830505003019","4","5","5","14","5","5","5","15","4","18","19",232,0.0314327351062757,7380.84036325811,"83"
"371830528033014","2","2","4","8","2","3","4","9","3","11","12",760,0.129316842090372,5877.03803862516,"232"
"371830537111015","4","1","2","7","4","1","2","7","3","10","10",63,0.00573062234630238,10993.5703651192,"17"
"371830528033063","1","1","2","4","1","2","2","5","3","7","8",0,0.0102723447806639,0,"0"
"371830541041044","3","3","3","9","4","4","3","11","2","11","13",251,0.0333359717117343,7529.40403749047,"125"
"371830538081018","2","1","2","5","2","1","2","5","3","8","8",0,0.00575527691046536,0,"0"
"371830540143016","2","2","2","6","2","3","2","7","3","9","10",33,0.00929797914548131,3549.15831533538,"16"
"371830541041015","1","2","2","5","3","3","2","8","5","10","13",4,0.111697412684003,35.8110354025492,"2"
"371830540143028","2","3","3","8","2","4","3","9","2","10","11",0,0.00346712572314055,0,"0"
"371830540171016","2","4","3","9","2","4","3","9","3","12","12",7,0.00948555200937094,737.964431915462,"3"
"371830540142012","3","3","1","7","3","4","2","9","4","11","13",0,0.000699551405883028,0,"0"
"371830541041031","2","2","2","6","4","3","3","10","2","8","12",0,0.0078120048738668,0,"0"
"371830521011013","2","2","4","8","2","3","4","9","3","11","12",24,0.00365209336426269,6571.57350763547,"13"
"371830505001003","4","4","5","13","4","5","5","14","3","16","17",56,0.0084143548079289,6655.29339780524,"28"
"371830505002004","5","5","5","15","5","5","5","15","4","19","19",20,0.00377778128664302,5294.11272979549,"10"
"371830545002087","1","2","4","7","1","3","4","8","3","10","11",0,0.00959434230489779,0,"0"
"371830542071074","1","4","1","6","1","4","1","6","2","8","8",45,0.0118060583685511,3811.60236509338,"12"
"371830540131004","4","5","2","11","4","5","2","11","4","15","15",6,0.0135746841887989,441.99923302458,"4"
"371830541061036","1","3","4","8","2","3","4","9","4","12","13",0,0.000814770592603284,0,"0"
"371830516001009","3","4","5","12","5","5","5","15","4","16","19",0,0.000340158344264897,0,"0"
"371830541131010","3","1","1","5","3","2","1","6","4","9","10",491,0.410187802097641,1197.01267928763,"170"
"371830512002010","5","5","5","15","5","5","5","15","4","19","19",39,0.00467631972522554,8339.89168653754,"21"
"371830524081000","4","5","5","14","4","5","5","14","5","19","19",41,0.00608014858724668,6743.25625626961,"19"
"371830540171043","3","4","3","10","3","5","3","11","2","12","13",0,0.00979806294891721,0,"0"
"371830540141019","2","2","1","5","2","3","2","7","4","9","11",98,0.0086108595454997,11380.9776459793,"27"
"371830540141023","2","2","1","5","2","3","2","7","4","9","11",231,0.0286732675181899,8056.2844765933,"66"
"371830506002006","5","4","5","14","5","5","5","15","3","17","18",79,0.0137808098848171,5732.60937929617,"28"
"371830506002038","5","4","5","14","5","5","5","15","4","18","19",1,0.00286770122164693,348.711362415119,"1"
"371830506002028","5","4","5","14","5","5","5","15","4","18","19",5,0.0057212073498552,873.941406812768,"5"
"371830508001014","5","5","5","15","5","5","5","15","5","20","20",8,0.000560583157035833,14270.853306227,"3"
"371830516001002","3","4","4","11","5","4","5","14","3","14","17",0,0.000865116851526728,0,"0"
"371830516001011","3","4","5","12","5","4","5","14","3","15","17",0,0.000616493212456563,0,"0"
"371830512002016","4","5","5","14","5","5","5","15","4","18","19",0,0.0125350617182031,0,"0"
"371830545003020","2","4","3","9","2","4","3","9","3","12","12",0,0.0918007777249133,0,"0"
"371830541061037","1","2","3","6","2","3","4","9","4","10","13",183,0.00435287480465609,42041.181566778,"82"
"371830520021000","4","5","4","13","4","5","5","14","5","18","19",158,0.048849553071921,3234.42058451133,"52"
"371830526011025","5","4","4","13","5","4","4","13","4","17","17",61,0.0162175319682408,3761.36147716297,"28"
"371830517003025","2","3","4","9","5","3","5","13","4","13","17",43,0.0288615927610799,1489.869265219,"19"
"371830541061021","1","3","3","7","1","3","4","8","2","9","10",0,0.00732667399244936,0,"0"
"371830526011031","5","3","4","12","5","3","4","12","4","16","16",28,0.0563591634513873,496.813619743513,"11"
"371830503002005","4","5","5","14","5","5","5","15","3","17","18",323,0.00670655868600831,48161.8092262229,"305"
"371830537143015","3","3","3","9","3","3","3","9","3","12","12",167,0.0160793965447817,10385.9619068974,"94"
"371830525062008","4","5","2","11","4","5","3","12","4","15","16",0,0.00473445045175386,0,"0"
"371830517003000","3","3","4","10","3","3","4","10","5","15","15",3,0.0662522928112196,45.2814517461041,"1"
"371830540131017","2","5","2","9","2","5","2","9","3","12","12",69,0.0406374570316139,1697.94089099427,"23"
"371830511012014","4","4","4","12","4","4","4","12","4","16","16",0,0.00282462120236455,0,"0"
"371830530081000","1","3","2","6","5","4","3","12","2","8","14",23,0.026137974543424,879.945764802444,"10"
"371830541042020","1","3","2","6","2","3","3","8","3","9","11",157,0.0240999689765612,6514.53120760001,"44"
"371830524072006","4","5","3","12","5","5","4","14","3","15","17",483,0.0856145305467117,5641.56571221836,"211"
"371830524041020","5","5","4","14","5","5","4","14","5","19","19",17,0.00572121168315951,2971.39853259403,"7"
"371830505002014","4","4","5","13","5","5","5","15","3","16","18",28,0.00495653895319475,5649.10318760887,"18"
"371830540131011","1","5","2","8","1","5","2","8","5","13","13",527,0.123045076969846,4282.9832202807,"185"
"371830540182005","2","2","3","7","2","3","3","8","2","9","10",25,0.00154042579592157,16229.2789864919,"15"
"371830540171006","2","4","2","8","2","4","2","8","2","10","10",0,0.018710127563562,0,"0"
"371830540132001","4","5","2","11","4","5","2","11","5","16","16",279,0.232888519792754,1197.99808186457,"80"
"371830510002005","5","5","5","15","5","5","5","15","5","20","20",0,0.000655897944879162,0,"0"
"371830527052022","2","2","4","8","2","2","4","8","4","12","12",67,0.0484270192750773,1383.52516844829,"24"
"371830542071079","1","2","1","4","1","2","1","4","2","6","6",0,0.00612609605901809,0,"0"
"371830514001000","4","4","5","13","4","5","5","14","3","16","17",52,0.0144338316268376,3602.64698552486,"23"
"371830514004011","4","5","5","14","4","5","5","14","5","19","19",22,0.00785832462935521,2799.57892269018,"21"
"371830514002012","5","5","5","15","5","5","5","15","4","19","19",81,0.0122543082244685,6609.92024325496,"29"
"371830542081088","1","2","1","4","1","2","1","4","2","6","6",530,0.0766639203916549,6913.29111911282,"302"
"371830516004005","3","4","4","11","3","4","5","12","3","14","15",104,0.0358671332116926,2899.59053560757,"37"
"371830540171062","4","5","3","12","4","5","3","12","2","14","14",2,0.0139881375828623,142.978290580321,"1"
"371830540151034","4","4","3","11","4","4","3","11","2","13","13",16,0.0160973809571981,993.950509250108,"10"
"371830540141082","2","2","1","5","2","3","2","7","3","8","10",81,0.0201413763488972,4021.57223999416,"24"
"371830540171048","3","5","3","11","3","5","3","11","2","13","13",0,0.00522813278139576,0,"0"
"371830509002021","5","5","5","15","5","5","5","15","5","20","20",83,0.00687810936513455,12067.2695931139,"27"
"371830512003014","5","5","5","15","5","5","5","15","4","19","19",30,0.00526633967942801,5696.55620908569,"9"
"371830517003009","3","3","4","10","5","3","5","13","5","15","18",68,0.0700413660595688,970.854850862951,"26"
"371830540141045","3","3","2","8","3","4","2","9","4","12","13",242,0.0172970208880384,13990.8485725049,"100"
"371830540134040","1","4","1","6","1","4","1","6","5","11","11",59,0.00528581256347315,11161.9546269406,"17"
"371830540134004","1","4","1","6","1","4","1","6","5","11","11",126,0.0283709816038094,4441.1575799366,"65"
"371830540181032","4","4","4","12","4","4","4","12","2","14","14",0,0.00134448235136051,0,"0"
"371830541041016","1","1","1","3","5","3","2","10","4","7","14",0,0.615751630034221,0,"0"
"371830517003020","4","3","4","11","4","3","5","12","5","16","17",91,0.285247770167865,319.020898731119,"36"
"371830516003006","4","4","5","13","4","4","5","13","3","16","16",1,0.005434081075691,184.023754167643,"1"
"371830540151006","1","4","2","7","2","4","3","9","2","9","11",3,0.0593360851475179,50.5594528614683,"1"
"371830540132055","2","5","2","9","2","5","2","9","4","13","13",91,0.0140263533572816,6487.78750128654,"55"
"371830524041005","5","5","4","14","5","5","4","14","3","17","17",19,0.00848675081096773,2238.78377287167,"8"
"371830514005022","5","5","5","15","5","5","5","15","3","18","18",13,0.0102086068243688,1273.43527120351,"4"
"371830507002010","5","5","5","15","5","5","5","15","4","19","19",76,0.00825484627766824,9206.71293487343,"33"
"371830540163007","4","5","3","12","4","5","3","12","5","17","17",35,0.00675108441233597,5184.35229991288,"11"
"371830541103027","1","1","1","3","5","2","2","9","2","5","11",0,0.0103266037749483,0,"0"
"371830512001005","4","5","5","14","5","5","5","15","3","17","18",51,0.0109114064017682,4674.0079254802,"26"
"371830528061018","2","1","2","5","2","3","3","8","4","9","12",0,0.00105914864602315,0,"0"
"371830528033040","4","2","4","10","4","2","4","10","2","12","12",12,0.00872932368871197,1374.67694267282,"3"
"371830524082012","4","5","4","13","4","5","4","13","4","17","17",36,0.00208395492878344,17274.8457765428,"16"
"371830519002008","4","4","5","13","4","5","5","14","4","17","18",61,0.0231030804849985,2640.34053985177,"28"
"371830515012011","4","2","4","10","4","3","4","11","4","14","15",29,0.0215724115367383,1344.30960352357,"15"
"371830545002057","1","2","3","6","1","2","3","6","2","8","8",3,0.00384015309666022,781.218853646511,"1"
"371830516005021","4","4","5","13","5","5","5","15","3","16","18",0,0.0029812763683481,0,"0"
"371830516003003","4","4","5","13","5","5","5","15","3","16","18",87,0.0575970186407919,1510.49484943973,"42"
"371830542071087","3","5","1","9","3","5","1","9","3","12","12",50,0.0107503593256719,4651.00732778298,"16"
"371830512001007","5","5","5","15","5","5","5","15","3","18","18",64,0.00882733666860449,7250.20494886344,"42"
"371830542071109","3","5","1","9","3","5","1","9","3","12","12",94,0.00737220600579271,12750.5932316785,"43"
"371830541102011","2","1","1","4","2","1","1","4","3","7","7",114,0.0163563332229948,6969.77729945803,"39"
"371830512002000","4","5","5","14","5","5","5","15","3","17","18",436,0.0788651055822198,5528.42726553449,"336"
"371830516001018","3","4","5","12","4","4","5","13","3","15","16",90,0.0138992092112089,6475.18852564794,"31"
"371830518002013","4","4","5","13","4","4","5","13","3","16","16",33,0.00676641296683695,4877.03014311086,"15"
"371830503001013","5","5","5","15","5","5","5","15","3","18","18",0,0.000876365425934789,0,"0"
"371830527051004","3","3","4","10","3","4","4","11","2","12","13",153,0.0293543067540622,5212.18236498898,"44"
"371830527072021","3","4","3","10","3","4","4","11","2","12","13",59,0.0210882415433517,2797.76765069349,"24"
"371830540162023","2","3","2","7","2","4","3","9","2","9","11",0,0.00355229580682607,0,"0"
"371830536102012","4","5","2","11","4","5","2","11","1","12","12",52,0.00964145463995642,5393.37703094095,"28"
"371830525052015","2","3","3","8","2","3","4","9","4","12","13",0,0.000100060529274348,0,"0"
"371830537232016","4","3","3","10","5","3","4","12","5","15","17",0,0.00317772945282957,0,"0"
"371830517003003","5","3","4","12","5","4","5","14","5","17","19",0,0.000135368387971781,0,"0"
"371830537072017","5","4","4","13","5","4","4","13","4","17","17",18,0.00466563877222507,3857.99263053871,"7"
"371830505001004","5","4","5","14","5","5","5","15","3","17","18",18,0.00433513382432133,4152.12095622398,"12"
"371830537093021","1","5","1","7","1","5","1","7","2","9","9",23,0.0231604567250519,993.071953331632,"10"
"371830524011003","3","5","2","10","3","5","2","10","4","14","14",28,0.0181366846632543,1543.83232216245,"10"
"371830506002033","5","5","5","15","5","5","5","15","4","19","19",10,0.00356181904191595,2807.55419697595,"4"
"371830540151002","2","3","2","7","2","3","3","8","2","9","10",0,0.0166230206765461,0,"0"
"371830540161010","4","5","3","12","4","5","3","12","4","16","16",25,0.00776912616975592,3217.86510525744,"13"
"371830540161013","3","4","2","9","3","4","2","9","3","12","12",34,0.00611622342090036,5558.9859395612,"13"
"371830526022003","4","3","4","11","4","3","4","11","2","13","13",156,0.0635755626580564,2453.77301399678,"59"
"371830540083001","2","2","3","7","4","3","4","11","2","9","13",816,0.0627452560929059,13004.9672407387,"333"
"371830540143011","1","3","2","6","1","4","2","7","2","8","9",0,0.12431221345924,0,"0"
"371830526021023","3","2","4","9","3","2","4","9","2","11","11",33,0.00915595847456303,3604.2103174321,"16"
"371830526021024","3","3","4","10","3","3","4","10","3","13","13",82,0.0178743914704418,4587.56876482203,"32"
"371830536102107","4","5","2","11","4","5","2","11","1","12","12",164,0.00633562370792179,25885.3757042012,"103"
"371830518001034","5","4","5","14","5","5","5","15","3","17","18",48,0.0102790480282794,4669.69313383338,"18"
"371830526022009","4","3","4","11","4","3","4","11","2","13","13",36,0.0179323231219193,2007.54803241282,"16"
"371830526012005","4","4","4","12","4","4","4","12","4","16","16",41,0.0155874071772604,2630.32841406829,"21"
"371830524063020","1","2","2","5","5","2","3","10","2","7","12",313,0.029746103358026,10522.3866209538,"118"
"371830517001009","5","4","5","14","5","5","5","15","5","19","20",73,0.0221615835563947,3293.98843788562,"30"
"371830536102040","4","1","2","7","4","1","2","7","1","8","8",702,0.0845012080464397,8307.57353923507,"365"
"371830536101009","1","5","1","7","1","5","1","7","1","8","8",44,0.000723479197745592,60817.2289363769,"26"
"371830511012012","4","5","5","14","4","5","5","14","5","19","19",132,0.0123371451477814,10699.3958828261,"59"
"371830528064059","1","1","1","3","1","2","1","4","4","7","8",40,0.00805489802397358,4965.9225828743,"13"
"371830521021022","4","4","4","12","4","4","5","13","3","15","16",33,0.0040284352048545,8191.76636134871,"14"
"371830528033026","2","2","4","8","2","3","4","9","3","11","12",44,0.00350603029026162,12549.8060077275,"9"
"371830540182009","1","2","3","6","1","3","3","7","2","8","9",0,0.0039556269364346,0,"0"
"371830527073043","2","2","3","7","2","3","4","9","3","10","12",0,0.00935835499891964,0,"0"
"371830540131051","3","5","3","11","3","5","3","11","5","16","16",0,0.0314747834966742,0,"0"
"371830524092004","4","5","4","13","4","5","5","14","5","18","19",376,0.0463509186769263,8112.02907585895,"1"
"371830523021016","3","5","4","12","3","5","5","13","5","17","18",0,0.0223323913882352,0,"0"
"371830541062027","4","4","4","12","4","4","5","13","3","15","16",6,0.158475107012146,37.8608357686115,"2"
"371830524062018","1","5","2","8","2","5","3","10","3","11","13",203,0.0532551930267154,3811.83483642929,"94"
"371830524041019","4","5","4","13","4","5","4","13","5","18","18",45,0.0101923099487336,4415.09336218639,"20"
"371830523023029","4","5","3","12","4","5","4","13","3","15","16",18,0.0353483000254237,509.218264727124,"10"
"371830506001002","4","4","5","13","4","4","5","13","3","16","16",583,0.13724424211413,4247.90134011733,"8"
"371830504002004","5","4","5","14","5","4","5","14","3","17","17",31,0.00214293132079684,14466.1659004885,"18"
"371830545001043","4","5","5","14","4","5","5","14","5","19","19",0,0.0243682692685273,0,"0"
"371830518001029","5","4","5","14","5","4","5","14","3","17","17",25,0.0101245120770193,2469.25479567013,"14"
"371830541054011","3","4","3","10","3","4","3","10","3","13","13",428,0.061765258602394,6929.46179915145,"140"
"371830536101078","1","5","1","7","1","5","1","7","1","8","8",180,0.0162486984996934,11077.8103245252,"107"
"371830506003009","5","5","5","15","5","5","5","15","5","20","20",38,0.00687706402023593,5525.61382127374,"19"
"371839802001019","1","1","1","3","1","1","1","3","1","4","4",27,1.37901280633553,19.5792235401697,"9"
"371830523023020","2","5","3","10","2","5","3","10","2","12","12",3,0.00462451087727639,648.71725456225,"1"
"371830523022007","4","5","4","13","4","5","4","13","3","16","16",73,0.0171565740975656,4254.92872789552,"30"
"371830523023028","4","5","4","13","4","5","4","13","3","16","16",75,0.0122018699505137,6146.59886592565,"25"
"371830541054008","3","4","3","10","3","4","3","10","3","13","13",220,0.0363890279168854,6045.77842811554,"87"
"371830541111011","1","1","1","3","1","1","1","3","2","5","5",6,0.482287428246358,12.4407140816765,"2"
"371830527052012","4","3","4","11","4","3","5","12","3","14","15",0,0.0975470898954321,0,"0"
"371830527051024","3","3","3","9","3","3","4","10","2","11","12",40,0.0225219189073721,1776.0475989862,"21"
"371830541103002","1","1","1","3","3","1","1","5","2","5","7",0,0.0059748576089813,0,"0"
"371830541063041","2","2","2","6","2","2","2","6","3","9","9",0,0.0064243342710629,0,"0"
"371830507002007","5","5","5","15","5","5","5","15","5","20","20",47,0.00453340534272042,10367.4823773416,"20"
"371830541042023","4","5","3","12","4","5","3","12","5","17","17",178,0.0413463313433363,4305.09779747818,"62"
"371830540132002","5","5","2","12","5","5","3","13","5","17","18",0,0.000776852005763869,0,"0"
"371830512003023","5","5","5","15","5","5","5","15","4","19","19",0,0.00389194561437525,0,"0"
"371830512002012","5","5","5","15","5","5","5","15","4","19","19",63,0.00836586329671852,7530.60356899586,"31"
"371830542071080","1","2","1","4","1","2","1","4","2","6","6",0,0.0650905560306016,0,"0"
"371830541062022","3","3","3","9","3","4","4","11","3","12","14",18,0.0707071879609269,254.571006415174,"8"
"371830527071009","3","4","3","10","3","4","3","10","2","12","12",88,0.0330644611146288,2661.46784291809,"59"
"371830524081013","4","5","4","13","4","5","5","14","4","17","18",79,0.01069347207112,7387.68469909381,"30"
"371830541061010","1","2","2","5","1","2","3","6","2","7","8",37,0.592558186730988,62.4411253249588,"4"
"371830537131005","2","2","3","7","2","2","3","7","4","11","11",44,0.00426338282436092,10320.4431346358,"23"
"371830510002001","4","5","5","14","5","5","5","15","5","19","20",0,0.00366171050856284,0,"0"
"371830537241061","2","5","2","9","2","5","2","9","2","11","11",0,0.0192028529487693,0,"0"
"371830537251023","2","5","2","9","2","5","2","9","3","12","12",37,0.00237221372700962,15597.2455511594,"23"
"371830523013002","3","5","4","12","3","5","4","12","5","17","17",0,0.000729539449430098,0,"0"
"371830540141080","1","3","2","6","1","3","2","6","3","9","9",96,0.0283821326862468,3382.40966812614,"31"
"371830540151010","5","4","3","12","5","4","3","12","2","14","14",50,0.00622379294102486,8033.68628644747,"16"
"371830540151032","3","3","3","9","3","4","3","10","2","11","12",15,0.0206413111063787,726.698024301597,"6"
"371830537211015","2","1","1","4","2","1","1","4","2","6","6",105,0.153143134267668,685.63308764778,"42"
"371830537171033","1","1","1","3","5","1","2","8","1","4","9",0,0.12459029055242,0,"0"
"371830540171013","2","4","3","9","2","4","3","9","3","12","12",2,0.016060912702715,124.52592433691,"1"
"371830527011006","4","2","4","10","4","3","4","11","2","12","13",87,0.0222426955328921,3911.39643445399,"34"
"371830545001038","3","5","4","12","3","5","4","12","4","16","16",0,0.058725764938774,0,"0"
"371830523021050","5","5","5","15","5","5","5","15","5","20","20",124,0.0465045976019126,2666.40303097473,"1"
"371830520012005","2","3","4","9","5","4","5","14","4","13","18",0,0.022008457174039,0,"0"
"371830542091073","3","2","1","6","3","3","1","7","3","9","10",2,0.0156279479514341,127.975854937274,"1"
"371830545003009","1","2","3","6","1","2","3","6","2","8","8",69,0.00507341385064536,13600.3097778477,"47"
"371830523013023","3","5","3","11","3","5","3","11","4","15","15",0,0.000899375635027261,0,"0"
"371830545003018","1","4","3","8","1","4","3","8","2","10","10",15,0.00355113139238296,4224.00591320682,"8"
"371830517001017","5","4","5","14","5","5","5","15","5","19","20",42,0.0123278335931005,3406.92463787848,"14"
"371830527013025","4","4","5","13","4","4","5","13","5","18","18",0,0.0309238832044508,0,"0"
"371830527061004","3","3","3","9","3","3","4","10","3","12","13",25,0.0032860917820248,7607.82158817112,"13"
"371830541062015","4","2","2","8","4","3","3","10","3","11","13",0,0.0706074658757838,0,"0"
"371830527061034","2","2","4","8","2","3","5","10","4","12","14",0,0.00288499861430228,0,"0"
"371830527011016","4","3","4","11","4","3","4","11","2","13","13",199,0.0794668325126822,2504.18940465812,"74"
"371830540141017","4","3","2","9","4","4","2","10","4","13","14",56,0.00460142177417937,12170.1514767112,"25"
"371830540134038","1","4","1","6","1","4","1","6","4","10","10",155,0.0173606254730576,8928.24974771494,"70"
"371830540142010","3","3","1","7","3","4","2","9","3","10","12",28,0.0139234529180376,2010.99541649804,"5"
"371830537261000","2","5","2","9","2","5","2","9","5","14","14",49,0.0224209912830024,2185.4519892324,"20"
"371830527073001","3","4","3","10","3","4","3","10","2","12","12",95,0.106362487217808,893.172042935211,"46"
"371830527073000","5","5","3","13","5","5","4","14","2","15","16",77,0.0366483141284943,2101.05162627746,"34"
"371830518003020","4","4","5","13","5","4","5","14","4","17","18",0,0.00381772757322925,0,"0"
"371830527061019","5","3","4","12","5","3","4","12","3","15","15",47,0.0119841452387424,3921.84833074773,"18"
"371830528063002","4","1","2","7","4","2","2","8","4","11","12",559,0.103690685638944,5391.03388655818,"183"
"371830527052009","4","3","4","11","4","3","4","11","2","13","13",157,0.0269360502721109,5828.61995036277,"51"
"371830527051032","3","3","4","10","3","3","4","10","2","12","12",41,0.00563803099697348,7272.04231796686,"24"
"371830527073009","3","3","3","9","3","3","4","10","2","11","12",43,0.00502927977374787,8549.93198518283,"18"
"371830527063013","2","3","3","8","2","3","4","9","3","11","12",36,0.0168046604068994,2142.26286805651,"17"
"371830527063017","2","2","3","7","2","3","4","9","3","10","12",70,0.0161217971175509,4341.94770530854,"39"
"371830527052025","2","2","4","8","2","2","5","9","4","12","13",0,0.00675278246314576,0,"0"
"371830527073013","4","4","3","11","4","4","4","12","2","13","14",346,0.0540098625956369,6406.23736798677,"119"
"371830541061007","2","1","1","4","2","1","2","5","3","7","8",161,0.0131545184645775,12239.1405229725,"43"
"371830541051013","4","2","2","8","4","2","2","8","4","12","12",31,0.0306373674048234,1011.83628444262,"12"
"371830541055000","4","3","2","9","4","3","3","10","5","14","15",0,0.0399107721025201,0,"0"
"371830541051025","2","2","2","6","2","2","3","7","3","9","10",0,0.00847860508955795,0,"0"
"371830537111036","4","1","2","7","4","1","2","7","4","11","11",0,0.00222594520996037,0,"0"
"371830537112010","3","1","2","6","3","1","2","6","4","10","10",26,0.0219103196414561,1186.65544024314,"12"
"371830541042013","5","5","3","13","5","5","3","13","4","17","17",0,0.000673942196456785,0,"0"
"371830537131003","4","2","2","8","4","2","3","9","4","12","13",1432,0.179776663289145,7965.43874939335,"894"
"371830540083003","2","3","3","8","4","4","4","12","2","10","14",90,0.0150565193724275,5977.47711631241,"50"
"371830538082015","1","1","2","4","5","2","3","10","4","8","14",0,0.00238765209534308,0,"0"
"371830528072026","3","1","1","5","3","2","1","6","2","7","8",9,0.00378943360933572,2375.02511663681,"2"
"371830541131003","2","2","1","5","2","3","2","7","4","9","11",60,0.0267332306249474,2244.39765031646,"18"
"371830527073021","4","4","3","11","4","4","4","12","3","14","15",0,0.00179973522431434,0,"0"
"371830541052012","1","2","2","5","1","2","2","5","4","9","9",3,0.00519108798582568,577.913533384818,"1"
"371830541051040","4","3","2","9","4","3","2","9","4","13","13",0,0.00154056130691937,0,"0"
"371830525033027","3","5","3","11","3","5","3","11","4","15","15",2,0.0154221956198685,129.683220813474,"2"
"371830504001022","5","4","5","14","5","4","5","14","3","17","17",83,0.0108509391220353,7649.10751655122,"33"
"371830521013005","5","4","4","13","5","4","5","14","3","16","17",870,0.29275443598842,2971.77392739631,"311"
"371830524011082","1","5","2","8","1","5","2","8","2","10","10",0,0.00455186900188482,0,"0"
"371830511012009","5","4","4","13","5","4","5","14","4","17","18",71,0.00680177386862167,10438.453463962,"26"
"371830536102039","5","1","2","8","5","1","2","8","1","9","9",250,0.0444206839593327,5628.00879493156,"91"
"371830526021009","3","3","4","10","3","3","4","10","3","13","13",47,0.0106424320168008,4416.28378981448,"18"
"371830528064028","4","1","1","6","4","3","2","9","3","9","12",152,0.0199274192687089,7627.68113373709,"49"
"371830508003006","4","5","5","14","4","5","5","14","4","18","18",1778,0.311894109441017,5700.65270930114,"6"
"371830519001032","4","4","5","13","5","4","5","14","3","16","17",72,0.0462884265625606,1555.46440755961,"31"
"371830520022000","4","4","4","12","4","4","5","13","4","16","17",172,0.0668630900231485,2572.42074723816,"64"
"371830537241074","2","5","2","9","2","5","2","9","3","12","12",0,0.00298683626766694,0,"0"
"371830541043012","1","2","2","5","5","3","3","11","2","7","13",0,0.00165726465194068,0,"0"
"371830540151011","5","4","3","12","5","4","3","12","2","14","14",112,0.0108754217637064,10298.4511712243,"36"
"371830537191009","1","1","1","3","2","1","1","4","1","4","5",31,0.00495138337444617,6260.87653805791,"11"
"371830518002021","5","4","5","14","5","4","5","14","4","18","18",39,0.00781880030300083,4987.97750148855,"20"
"371830537141010","4","2","2","8","4","2","3","9","4","12","13",81,0.0901073990153955,898.927289934987,"29"
"371830537152014","4","2","3","9","4","3","3","10","5","14","15",151,0.0563454044905183,2679.89912159403,"60"
"371830537093053","1","5","1","7","1","5","1","7","3","10","10",61,0.0121957747285295,5001.73226857847,"25"
"371830525051006","3","3","3","9","3","3","4","10","5","14","15",46,0.00809249946973199,5684.2759362607,"18"
"371830540071009","1","1","2","4","1","1","3","5","4","8","9",4,0.112998475175192,35.3987077595376,"1"
"371830540062005","4","4","4","12","4","4","4","12","4","16","16",76,0.0174874709446284,4345.96862180034,"27"
"371830540151039","5","4","3","12","5","4","3","12","2","14","14",44,0.0039052431780809,11266.9040040734,"18"
"371830540111003","2","3","2","7","2","4","3","9","3","10","12",49,0.028660914234739,1709.64539367724,"15"
"371830540171015","2","4","3","9","2","4","3","9","3","12","12",15,0.0415618593218398,360.907818965593,"8"
"371830540012000","4","2","4","10","4","3","4","11","3","13","14",331,0.151447218505491,2185.57992194487,"185"
"371830537141006","3","2","2","7","3","2","2","7","3","10","10",74,0.015379552408183,4811.58346068815,"29"
"371830527062020","2","1","3","6","2","2","4","8","3","9","11",8,0.00849804813998075,941.392643136771,"4"
"371830527041011","5","3","4","12","5","3","4","12","2","14","14",0,0.00232116709121503,0,"0"
"371830537241052","2","5","2","9","2","5","2","9","2","11","11",330,0.0688121472740428,4795.66490907168,"132"
"371830537131010","3","2","3","8","3","2","3","8","5","13","13",20,0.00251240426069112,7960.50234148955,"10"
"371830537241058","2","5","2","9","2","5","2","9","2","11","11",0,0.000955022475524403,0,"0"
"371830537262002","2","5","2","9","2","5","2","9","4","13","13",2,0.00260698863333786,767.168669024576,"1"
"371830518003011","4","4","5","13","4","4","5","13","4","17","17",40,0.00867351910221766,4611.73827238966,"22"
"371830540122000","2","3","3","8","2","3","3","8","2","10","10",509,0.413761650837909,1230.17683965931,"227"
"371830540141012","2","2","1","5","3","4","2","9","4","9","13",57,0.00472274884502445,12069.2422719136,"16"
"371830540143004","1","2","1","4","1","3","2","6","2","6","8",45,0.00567756829714623,7925.92843358992,"21"
"371830516002014","4","4","4","12","4","4","5","13","3","15","16",34,0.0125328039625729,2712.88054146025,"14"
"371830516002009","2","4","4","10","3","4","5","12","3","13","15",46,0.00897355055127538,5126.1760589806,"23"
"371830540132022","2","4","1","7","2","5","2","9","4","11","13",88,0.0128473258042332,6849.67450354563,"37"
"371830527013023","3","3","4","10","3","3","5","11","5","15","16",0,0.0603907225197747,0,"0"
"371830516001003","2","4","4","10","4","4","5","13","3","13","16",25,0.00256499064949852,9746.62422449289,"15"
"371830516005017","3","4","5","12","5","5","5","15","3","15","18",40,0.00909386718786081,4398.5687467918,"12"
"371830518002029","5","4","5","14","5","5","5","15","3","17","18",35,0.00313313147920058,11170.9324145345,"12"
"371830541041022","1","1","1","3","1","1","1","3","2","5","5",3,0.597312832550856,5.02249380310204,"2"
"371830541041049","3","3","2","8","3","3","2","8","4","12","12",52,0.00622047498073851,8359.49025774016,"15"
"371830540132016","2","4","1","7","2","5","2","9","4","11","13",120,0.0158982001409667,7548.02423771116,"30"
"371830540081002","4","4","3","11","4","4","3","11","3","14","14",5,0.00248259359559529,2014.02275784131,"5"
"371830540141049","3","4","2","9","3","5","2","10","4","13","14",222,0.0232410163446969,9552.07796025048,"39"
"371830503001029","5","5","5","15","5","5","5","15","3","18","18",0,0.00405529492542764,0,"0"
"371830524091000","5","5","4","14","5","5","5","15","4","18","19",388,0.0200936969307684,19309.5377787786,"169"
"371830528033023","2","2","3","7","2","3","4","9","3","10","12",31,0.00350132509968232,8853.79081274476,"12"
"371830528061013","1","1","2","4","3","3","3","9","5","9","14",0,0.00015479958798219,0,"0"
"371830528064019","3","1","1","5","3","2","2","7","3","8","10",153,0.0272817366357642,5608.14738602194,"56"
"371830524011022","1","5","2","8","1","5","3","9","4","12","13",562,0.121372869346263,4630.35934659069,"298"
"371830542071114","1","2","1","4","1","2","1","4","2","6","6",104,0.00495359355079271,20994.8593750404,"44"
"371830545001035","5","5","5","15","5","5","5","15","5","20","20",18,0.036534436484383,492.685852912889,"8"
"371830525032010","3","5","3","11","3","5","3","11","4","15","15",214,0.0859260768024633,2490.51286831084,"87"
"371830520024002","3","4","5","12","5","4","5","14","4","16","18",203,0.0663767940316379,3058.29775242296,"74"
"371830528064015","1","1","1","3","1","2","1","4","4","7","8",718,0.110728515640966,6484.3278702308,"212"
"371830542071032","1","2","1","4","1","2","1","4","2","6","6",305,0.133994907340395,2276.20591001411,"138"
"371830542071034","1","4","1","6","1","4","1","6","2","8","8",39,0.00390714016685537,9981.72533732999,"12"
"371830528064029","4","1","1","6","4","3","2","9","3","9","12",78,0.00689144793616616,11318.3761558522,"22"
"371830510002000","5","5","5","15","5","5","5","15","5","20","20",0,0.0185465192944664,0,"0"
"371830501001076","5","5","5","15","5","5","5","15","4","19","19",0,0.00536895008079037,0,"0"
"371830516005019","5","4","5","14","5","5","5","15","3","17","18",170,0.0413491541775494,4111.32956359968,"5"
"371830524063013","1","2","2","5","4","2","2","8","2","7","10",1011,0.107575659741892,9398.03671597928,"543"
"371830521021015","2","3","4","9","2","3","4","9","5","14","14",45,0.0653066351910461,689.057089962732,"12"
"371830516002011","4","4","4","12","4","4","5","13","3","15","16",74,0.0372828653248078,1984.82598789854,"32"
"371830501001073","5","5","5","15","5","5","5","15","4","19","19",0,0.00512701180442857,0,"0"
"371830505001021","5","4","5","14","5","5","5","15","4","18","19",67,0.00628611600383873,10658.4097333051,"52"
"371830537142012","3","2","3","8","3","2","3","8","4","12","12",15,0.0110666088551124,1355.42876741962,"7"
"371830520022014","4","3","4","11","4","4","5","13","5","16","18",105,0.0382614142851797,2744.27911151918,"35"
"371830521021000","4","5","4","13","4","5","4","13","5","18","18",72,0.00729024748666227,9876.20792459052,"16"
"371830510002015","5","5","5","15","5","5","5","15","5","20","20",0,0.0067346791620948,0,"0"
"371830505002002","5","5","5","15","5","5","5","15","4","19","19",170,0.118721301557374,1431.92500225282,"77"
"371830526021025","3","2","3","8","3","2","4","9","2","10","11",139,0.0329261688340224,4221.56615610779,"50"
"371830526011026","5","4","4","13","5","4","4","13","4","17","17",51,0.0130513491307379,3907.64199847259,"21"
"371830526011011","3","3","4","10","4","3","4","11","3","13","14",78,0.0281381894521672,2772.03336528081,"31"
"371830542091065","3","2","1","6","3","3","1","7","3","9","10",141,0.0168576373194639,8364.16143780722,"41"
"371830545001045","4","4","4","12","4","4","5","13","4","16","17",0,0.000216855436593688,0,"0"
"371830524071015","3","5","4","12","3","5","4","12","3","15","15",82,0.0113436010686333,7228.74504347145,"33"
"371830515022021","5","4","4","13","5","4","5","14","4","17","18",0,0.00126257083988085,0,"0"
"371830510001014","4","5","5","14","5","5","5","15","4","18","19",18,0.00147636747271438,12192.0865453003,"9"
"371830524011050","1","5","2","8","1","5","3","9","5","13","14",74,0.0386491699643826,1914.65948863055,"42"
"371830524011043","1","5","2","8","1","5","3","9","4","12","13",37,0.00294303016840256,12572.0763576417,"37"
"371830525032026","4","5","3","12","4","5","4","13","3","15","16",22,0.00393560420374213,5589.99301278353,"10"
"371830525033026","3","5","3","11","3","5","3","11","4","15","15",34,0.00190255743552727,17870.682569211,"21"
"371830524011023","1","5","1","7","1","5","1","7","2","9","9",0,0.0114243273220204,0,"0"
"371830525033007","1","5","3","9","1","5","3","9","5","14","14",0,0.000822826224304751,0,"0"
"371830527063010","2","2","3","7","2","2","4","8","3","10","11",0,0.00333064478991437,0,"0"
"371830525031015","2","5","2","9","2","5","2","9","3","12","12",255,0.0494273723619102,5159.08468961033,"185"
"371830540171041","2","3","2","7","3","4","3","10","2","9","12",0,0.000144667107410397,0,"0"
"371830540151017","2","3","2","7","2","3","3","8","3","10","11",131,0.0335719933287318,3902.06201690999,"42"
"371830515022018","5","4","4","13","5","4","5","14","4","17","18",76,0.0181711995697496,4182.44264547733,"40"
"371830526031002","4","2","3","9","4","3","4","11","5","14","16",88,0.0624001478519429,1410.25306877153,"34"
"371830514001001","5","4","5","14","5","5","5","15","3","17","18",45,0.0114824100388326,3919.03788906802,"17"
"371830541103015","1","1","1","3","3","2","1","6","2","5","8",56,0.324157333534677,172.755616506851,"23"
"371830536101059","2","5","1","8","2","5","1","8","1","9","9",0,0.00302136934327062,0,"0"
"371830523021048","4","5","5","14","4","5","5","14","5","19","19",0,0.078981862040694,0,"0"
"371830527051019","5","3","4","12","5","3","4","12","2","14","14",0,0.014522516864208,0,"0"
"371830527072018","3","3","4","10","3","3","4","10","3","13","13",33,0.0194590009969509,1695.87328790265,"9"
"371830541061028","1","2","2","5","1","2","3","6","2","7","8",31,0.0151079190248943,2051.90403449471,"5"
"371830541111017","1","1","1","3","2","1","1","4","2","5","6",266,0.32019562156665,830.742152870542,"117"
"371830541042009","2","2","2","6","2","2","2","6","3","9","9",272,0.0222476357375753,12226.0182254155,"60"
"371830509001013","4","5","5","14","4","5","5","14","4","18","18",0,0.0111185181333439,0,"0"
"371830545001037","3","5","4","12","3","5","5","13","4","16","17",0,0.0430491810256512,0,"0"
"371830521014010","3","3","4","10","3","4","5","12","4","14","16",0,0.0045567324255074,0,"0"
"371830519001021","4","4","5","13","5","5","5","15","3","16","18",40,0.0111289592634784,3594.22647284431,"16"
"371830506002025","5","4","5","14","5","4","5","14","3","17","17",9,0.00329146700805948,2734.34306889986,"5"
"371830538083030","3","5","2","10","3","5","2","10","4","14","14",112,0.0224182561382412,4995.92828761332,"42"
"371830540132013","1","3","1","5","1","4","1","6","5","10","11",102,0.0138039819816067,7389.17220667999,"25"
"371830537071008","2","2","3","7","2","2","3","7","3","10","10",0,0.00661629992464463,0,"0"
"371830526022010","1","1","3","5","1","1","4","6","3","8","9",0,0.00924632903261259,0,"0"
"371830518003004","4","3","4","11","4","3","5","12","5","16","17",0,0.0138515020094502,0,"0"
"371830527043004","4","2","3","9","4","2","3","9","2","11","11",534,0.0282949223855528,18872.6440993052,"232"
"371830537071031","2","2","2","6","2","2","2","6","3","9","9",0,0.0242151419162912,0,"0"
"371830527012000","2","3","4","9","2","3","4","9","2","11","11",0,0.0176488162097186,0,"0"
"371830540132028","1","4","1","6","1","5","2","8","5","11","13",148,0.0181331796369981,8161.83388477703,"51"
"371830524062020","1","5","2","8","3","5","2","10","2","10","12",38,0.0375563669681312,1011.81245865036,"17"
"371830504001006","4","4","5","13","5","5","5","15","3","16","18",0,0.00217289880605841,0,"0"
"371830537151011","5","5","4","14","5","5","4","14","5","19","19",0,0.0353177204204622,0,"0"
"371830525071013","2","2","2","6","2","2","2","6","4","10","10",66,0.0221653024212527,2977.62686678786,"34"
"371830537222001","2","2","2","6","2","2","3","7","3","9","10",105,0.0310155569929373,3385.39785127541,"41"
"371830537232003","4","1","3","8","4","1","3","8","4","12","12",651,0.16830204827315,3868.04561607857,"349"
"371830537093039","1","5","1","7","1","5","1","7","2","9","9",19,0.0491094217027345,386.891137000337,"9"
"371830537152010","3","3","3","9","3","3","3","9","4","13","13",97,0.0209556338590543,4628.82681823959,"36"
"371830540134024","1","4","1","6","1","4","1","6","5","11","11",90,0.0101591506595646,8859.00829861863,"25"
"371830540181031","4","3","4","11","4","4","4","12","2","13","14",76,0.00995705366953489,7632.77998917828,"31"
"371830515022009","5","3","4","12","5","4","5","14","4","16","18",24,0.0133584756111835,1796.61218080209,"8"
"371830501001103","5","5","5","15","5","5","5","15","5","20","20",6,0.00253426526967791,2367.55010289928,"4"
"371830501001105","5","5","5","15","5","5","5","15","5","20","20",41,0.00856101588837356,4789.15125664943,"23"
"371830509002026","4","5","5","14","4","5","5","14","5","19","19",0,0.0458277709312954,0,"0"
"371830509002023","5","5","5","15","5","5","5","15","5","20","20",33,0.00731243764447035,4512.85899510604,"14"
"371830507001019","5","5","5","15","5","5","5","15","5","20","20",46,0.00533362928240461,8624.52142141783,"16"
"371830509002018","5","5","5","15","5","5","5","15","5","20","20",19,0.00487952747867396,3893.8196542677,"9"
"371830516004012","5","4","4","13","5","4","5","14","3","16","17",0,0.00351713353774217,0,"0"
"371830537232014","5","2","3","10","5","2","4","11","5","15","16",71,0.018981825850222,3740.41994485844,"32"
"371830526023004","3","3","4","10","3","3","4","10","3","13","13",67,0.0254073363577926,2637.03361330322,"34"
"371830540071011","3","2","3","8","3","2","3","8","5","13","13",427,0.0561444518235221,7605.38194125008,"211"
"371830540061009","2","2","3","7","2","2","3","7","4","11","11",119,0.0332970034933833,3573.89517118702,"40"
"371830540062002","2","2","3","7","2","2","3","7","3","10","10",148,0.0236232855901655,6265.00490099536,"58"
"371830540134006","4","5","3","12","4","5","3","12","4","16","16",0,0.0413016288444585,0,"0"
"371830540171060","1","3","3","7","1","4","3","8","2","9","10",0,4.78098193957749e-06,0,"0"
"371830527043021","4","2","3","9","4","2","3","9","2","11","11",114,0.0261600767445352,4357.78538087868,"55"
"371830524061008","1","2","2","5","2","2","2","6","2","7","8",283,0.0357302379294887,7920.46223029586,"107"
"371830512002019","4","5","5","14","5","5","5","15","4","18","19",65,0.00724792420479359,8968.08495279388,"26"
"371830514003008","5","5","5","15","5","5","5","15","5","20","20",76,0.0150473933064106,5050.70868105919,"40"
"371830524062008","1","2","2","5","4","2","2","8","2","7","10",910,0.111106032158462,8190.37438671318,"414"
"371830527013012","5","3","4","12","5","4","5","14","4","16","18",23,0.0128648655341043,1787.81503304701,"8"
"371830541051026","4","4","2","10","4","4","3","11","4","14","15",0,0.0560510908151509,0,"0"
"371830541061002","3","3","2","8","3","3","2","8","4","12","12",41,0.019376080222067,2116.01105745351,"12"
"371830540132047","1","4","1","6","1","4","1","6","5","11","11",52,0.00708054698094548,7344.06538646486,"25"
"371830541051004","2","1","1","4","2","2","2","6","3","7","9",166,0.0483376943196442,3434.17290246172,"70"
"371830541102007","4","2","1","7","4","3","1","8","4","11","12",51,0.00812923424026983,6273.65364222881,"15"
"371830542091042","2","1","1","4","2","1","1","4","3","7","7",0,0.00619462110213592,0,"0"
"371830524071006","2","5","4","11","3","5","4","12","3","14","15",71,0.00500758723841224,14178.4848909616,"28"
"371830501001074","5","5","5","15","5","5","5","15","4","19","19",2,0.00290735262347062,687.911051399236,"2"
"371830526012000","3","4","4","11","3","4","4","11","4","15","15",48,0.0331404241051081,1448.38218870595,"19"
"371830545001006","5","5","5","15","5","5","5","15","5","20","20",0,0.0115762026393293,0,"0"
"371830545001012","4","5","5","14","4","5","5","14","5","19","19",0,0.00271575425730064,0,"0"
"371830545001051","3","4","4","11","3","4","5","12","3","14","15",0,0.0125223536294049,0,"0"
"371830521014011","4","4","5","13","4","4","5","13","4","17","17",0,0.00630102134787519,0,"0"
"371830516005007","4","4","5","13","5","4","5","14","3","16","17",40,0.0100825533390357,3967.24903454123,"15"
"371830525052019","3","3","4","10","3","3","4","10","4","14","14",0,0.00946695620728322,0,"0"
"371830527072006","3","3","3","9","3","3","4","10","2","11","12",22,0.0413758277136617,531.711417406543,"9"
"371830541043022","2","2","2","6","4","3","3","10","3","9","13",157,0.0304969578463499,5148.05446467805,"49"
"371830520012013","4","4","5","13","4","4","5","13","3","16","16",104,0.0161766191271813,6429.03187509993,"37"
"371830520012009","4","4","5","13","4","4","5","13","3","16","16",4,0.00557017526300203,718.110258858213,"3"
"371830511023005","5","5","5","15","5","5","5","15","5","20","20",0,0.00929132993098488,0,"0"
"371830526021012","3","3","4","10","3","3","4","10","3","13","13",51,0.0163124648440327,3126.44351957985,"18"
"371830527051027","2","3","4","9","2","3","4","9","3","12","12",0,0.00459907918231378,0,"0"
"371830538084013","2","3","2","7","2","3","3","8","3","10","11",0,0.013600511544872,0,"0"
"371830541043027","1","2","2","5","5","3","3","11","2","7","13",133,0.0102237935541217,13008.8698775008,"48"
"371830535161001","1","2","1","4","2","2","2","6","2","6","8",0,0.0154486076847705,0,"0"
"371830537071000","3","2","3","8","3","2","3","8","3","11","11",193,0.0744209023456104,2593.35742939139,"82"
"371830528063005","4","1","2","7","4","2","2","8","4","11","12",91,0.00799409034107733,11383.4090080769,"34"
"371830541041011","1","3","1","5","2","4","2","8","4","9","12",0,0.00411993197517337,0,"0"
"371830541131014","2","1","1","4","2","2","2","6","3","7","9",5,0.0794975208378015,62.8950431070861,"2"
"371830537073001","5","2","3","10","5","3","4","12","5","15","17",377,0.041170316994446,9157.08276064182,"154"
"371830536101062","2","5","1","8","2","5","1","8","1","9","9",48,0.0170577882334541,2813.96388224948,"16"
"371830542102033","1","1","1","3","2","2","1","5","3","6","8",4,0.00285083194988923,1403.09919009973,"1"
"371830537162007","3","4","4","11","3","4","4","11","4","15","15",100,0.0521801326185853,1916.43821089835,"48"
"371830525052004","1","3","3","7","1","3","3","7","3","10","10",55,0.00614671913499498,8947.86288295974,"35"
"371830525051027","5","3","4","12","5","3","4","12","5","17","17",336,0.012830519616164,26187.5598223398,"137"
"371830525072004","3","5","2","10","3","5","2","10","4","14","14",0,0.000942125980298019,0,"0"
"371830538071021","3","2","3","8","3","2","3","8","3","11","11",268,0.0115623509754816,23178.6771192385,"152"
"371830537232015","3","1","2","6","3","1","3","7","4","10","11",368,0.097975020580413,3756.05943045415,"152"
"371830527061005","4","3","3","10","4","3","4","11","3","13","14",59,0.00793646225829187,7434.04278630039,"25"
"371830527061023","3","3","3","9","3","3","4","10","2","11","12",219,0.0557976929191052,3924.89345961854,"88"
"371830520021012","4","4","4","12","4","5","5","14","5","17","19",61,0.0151229591736007,4033.60210787874,"29"
"371830541044002","2","2","3","7","4","3","4","11","2","9","13",26,0.0122738219547146,2118.32957133722,"6"
"371830541051024","2","2","2","6","2","2","3","7","3","9","10",2,0.0161796248711115,123.612260230518,"1"
"371830527073005","2","3","3","8","2","3","4","9","2","10","11",300,0.0451841101032103,6639.50223462928,"126"
"371830527073024","3","3","3","9","3","3","4","10","2","11","12",503,0.109044685881341,4612.7878303703,"158"
"371830541061026","1","2","3","6","1","3","4","8","3","9","11",0,0.00214620824638148,0,"0"
"371830526021017","3","3","4","10","3","3","4","10","3","13","13",32,0.0110827557044634,2887.36852578212,"19"
"371830504001036","5","4","5","14","5","4","5","14","3","17","17",0,0.00575562221256577,0,"0"
"371830521021020","1","2","4","7","1","2","4","7","3","10","10",246,0.0553265665956622,4446.32687579944,"75"
"371830520022002","4","4","5","13","4","4","5","13","5","18","18",124,0.0209822544166262,5909.75581259482,"43"
"371830519001027","2","4","4","10","5","5","5","15","4","14","19",28,0.0215008556293278,1302.27375518057,"11"
"371830527052018","2","3","4","9","2","3","5","10","4","13","14",0,0.000443399466255648,0,"0"
"371830527052005","5","3","4","12","5","4","5","14","3","15","17",106,0.0148922761213798,7117.78368437736,"28"
"371830521011001","4","3","4","11","4","3","4","11","3","14","14",230,0.0327159680523636,7030.20615596253,"74"
"371830528033065","1","1","2","4","1","1","2","4","2","6","6",0,0.0150036457815891,0,"0"
"371830537261008","5","3","3","11","5","3","3","11","5","16","16",0,0.016980665888567,0,"0"
"371830540013006","4","2","3","9","4","3","4","11","3","12","14",320,0.0895894246514549,3571.85015134265,"163"
"371830521011018","4","2","4","10","4","2","4","10","3","13","13",596,0.088195958378126,6757.67927419923,"203"
"371830519002004","3","3","4","10","3","3","5","11","5","15","16",0,0.00159452654908535,0,"0"
"371830527073010","4","4","3","11","4","4","3","11","2","13","13",238,0.0209351910252934,11368.417881282,"69"
"371830541052006","1","2","2","5","1","2","2","5","3","8","8",667,0.112343457103784,5937.15038859646,"213"
"371830541053023","3","2","1","6","3","2","2","7","4","10","11",0,0.00463674023058099,0,"0"
"371830527072005","2","3","3","8","2","3","4","9","2","10","11",50,0.0412211215112298,1212.97039398549,"18"
"371830541054021","5","5","3","13","5","5","4","14","3","16","17",49,0.0246154245750947,1990.62176849783,"14"
"371830527073036","1","3","3","7","1","3","3","7","2","9","9",88,0.0105538239162652,8338.20998892898,"39"
"371830527051031","3","3","4","10","3","3","5","11","3","13","14",0,0.00411045435916786,0,"0"
"371830527061000","4","3","3","10","4","3","4","11","3","13","14",169,0.0350331994541617,4823.99559940633,"59"
"371830541051001","3","3","2","8","3","3","2","8","4","12","12",415,0.0989954799547454,4192.11059120793,"187"
"371830540012008","4","3","4","11","4","3","4","11","3","14","14",225,0.0288696164791566,7793.66086011036,"109"
"371830540141089","2","2","2","6","2","2","2","6","3","9","9",309,0.0909893477066631,3396.00192537013,"116"
"371830540143027","2","3","3","8","2","4","3","9","2","10","11",0,0.00557254818453901,0,"0"
"371830540161000","3","5","2","10","3","5","3","11","4","14","15",172,0.0297095038248871,5789.39321955013,"95"
"371830506003000","5","4","5","14","5","5","5","15","4","18","19",86,0.0128048591686139,6716.20037889956,"40"
"371830541052008","2","2","2","6","2","2","2","6","3","9","9",30,0.00284912997847111,10529.5301466374,"11"
"371830509001004","5","5","5","15","5","5","5","15","5","20","20",0,0.00573209456928742,0,"0"
"371830527061006","4","3","3","10","4","3","4","11","3","13","14",21,0.00411436561038945,5104.06754979955,"14"
"371830509002001","5","5","5","15","5","5","5","15","5","20","20",40,0.00406045081742096,9851.1228921636,"15"
"371830528062006","3","3","3","9","3","4","4","11","3","12","14",7,0.00139069172110817,5033.46636335915,"2"
"371830527052002","4","3","4","11","4","3","4","11","2","13","13",305,0.043481287802292,7014.51165353762,"98"
"371830527051023","3","3","4","10","3","3","4","10","2","12","12",148,0.0261697335274065,5655.38811639046,"63"
"371830536101082","1","5","1","7","1","5","2","8","1","8","9",128,0.00647924257799193,19755.3955511371,"70"
"371830536102075","3","1","1","5","3","1","1","5","1","6","6",0,0.166832104615938,0,"0"
"371830541103020","1","1","1","3","4","2","2","8","2","5","10",93,0.0176420169409336,5271.50610450997,"33"
"371830541103010","1","1","1","3","2","2","1","5","3","6","8",115,0.0179771390757305,6397.01342441371,"33"
"371830527072003","3","3","3","9","3","3","4","10","2","11","12",33,0.0199923017252447,1650.63535222311,"14"
"371830541054022","2","3","2","7","2","3","3","8","3","10","11",2,0.0341718830142159,58.5276497396405,"1"
"371830541063004","5","4","3","12","5","4","3","12","5","17","17",63,0.0399296325884297,1577.77559962461,"23"
"371830528063016","3","2","2","7","3","3","3","9","3","10","12",162,0.0258558528983901,6265.5059431471,"44"
"371830521012002","4","4","5","13","4","4","5","13","4","17","17",0,0.00180233696643542,0,"0"
"371830541062010","5","4","3","12","5","4","3","12","4","16","16",0,0.00961587486755831,0,"0"
"371830528062046","3","2","2","7","3","3","3","9","4","11","13",0,0.000397288081137424,0,"0"
"371830541043036","1","3","3","7","5","4","3","12","2","9","14",100,0.00641326144594319,15592.6903718009,"32"
"371830527073039","1","3","3","7","1","3","3","7","2","9","9",93,0.00961658718794451,9670.79049796233,"42"
"371830541053020","5","3","2","10","5","3","2","10","5","15","15",161,0.0251401226045552,6404.10560172956,"73"
"371830524082011","4","5","4","13","4","5","4","13","4","17","17",144,0.00950970908375478,15142.4190510719,"47"
"371830524011070","2","5","3","10","3","5","4","12","3","13","15",50,0.0135274346913553,3696.19230407022,"26"
"371830537093005","2","5","1","8","2","5","1","8","2","10","10",241,0.0378883262113017,6360.79827480244,"124"
"371830537171012","1","1","1","3","1","1","1","3","1","4","4",4,0.0540610941010663,73.9903634307154,"2"
"371830537171042","2","5","1","8","2","5","1","8","2","10","10",77,0.00794834728415852,9687.54852388812,"36"
"371830537181005","1","1","1","3","4","1","1","6","1","4","7",268,0.0382286696695596,7010.44536251285,"77"
"371830518003012","4","4","5","13","4","4","5","13","4","17","17",49,0.00920880963357424,5320.99174049073,"23"
"371830518001000","2","3","4","9","3","3","5","11","5","14","16",0,0.0488493075742778,0,"0"
"371830518002026","5","4","5","14","5","4","5","14","3","17","17",42,0.00420400999389815,9990.46150246082,"17"
"371830518001016","5","3","5","13","5","4","5","14","3","16","17",0,0.00383185157855689,0,"0"
"371830537152003","3","3","3","9","3","3","3","9","4","13","13",58,0.0156295383451717,3710.92214748091,"19"
"371830541052005","1","2","2","5","1","2","2","5","4","9","9",163,0.0266687245408348,6112.0283330542,"43"
"371830541055004","3","3","2","8","3","3","3","9","5","13","14",0,0.000512314933496128,0,"0"
"371830541051031","3","2","2","7","3","2","2","7","3","10","10",154,0.110620431624296,1392.14788569109,"74"
"371830524011065","1","5","2","8","1","5","3","9","3","11","12",132,0.0190876333191157,6915.47232667162,"52"
"371830525031002","1","5","2","8","1","5","2","8","3","11","11",39,0.0341481264223631,1142.08315611891,"19"
"371830540043002","4","4","4","12","4","4","4","12","2","14","14",41,0.0130310499476792,3146.33127527087,"15"
"371830540171042","3","4","3","10","3","5","3","11","2","12","13",0,0.000698600070246389,0,"0"
"371830540143018","3","2","1","6","3","3","2","8","3","9","11",66,0.0704272525517423,937.137224705881,"24"
"371830537073009","4","3","3","10","4","3","4","11","5","15","16",589,0.0774836708050531,7601.6016520682,"377"
"371830514005017","5","5","5","15","5","5","5","15","3","18","18",135,0.0212139971843507,6363.72291496239,"63"
"371830540132029","1","4","1","6","1","5","2","8","5","11","13",87,0.0111258769619622,7819.60831469203,"24"
"371830537093015","3","5","2","10","3","5","2","10","2","12","12",222,0.0138879510137361,15985.0794246341,"130"
"371830537231007","3","2","3","8","3","2","3","8","3","11","11",30,0.0145980643484775,2055.06697900868,"18"
"371830525052013","2","3","3","8","2","3","4","9","4","12","13",68,0.00422502857785474,16094.5656927431,"31"
"371830537072014","5","4","4","13","5","4","4","13","4","17","17",93,0.0178525518347276,5209.33930683747,"63"
"371830537073000","4","2","3","9","5","2","3","10","4","13","14",92,0.0500641205157257,1837.6433871659,"46"
"371830537221005","2","2","2","6","2","2","3","7","3","9","10",375,0.0660595058270421,5676.7000495255,"194"
"371830541041032","2","3","2","7","3","4","3","10","3","10","13",0,0.00205459354145074,0,"0"
"371830524011064","1","5","2","8","1","5","3","9","3","11","12",55,0.0180971361855267,3039.15489368902,"25"
"371830524043003","5","5","4","14","5","5","4","14","4","18","18",17,0.00580291811925884,2929.56055050649,"7"
"371830542071076","1","2","1","4","1","2","1","4","2","6","6",0,0.00770115405090858,0,"0"
"371830524043004","4","5","4","13","4","5","4","13","4","17","17",49,0.0176039496545022,2783.46626533713,"23"
"371830501001100","5","5","5","15","5","5","5","15","5","20","20",0,0.00843647181762612,0,"0"
"371830523021008","3","5","4","12","3","5","5","13","5","17","18",276,0.0756887065950501,3646.51494808407,"214"
"371830517003005","3","3","4","10","3","3","4","10","4","14","14",140,0.159178709977554,879.514603553083,"46"
"371830511023000","5","5","5","15","5","5","5","15","5","20","20",96,0.0565910102324771,1696.38251032505,"58"
"371830512003019","5","5","5","15","5","5","5","15","4","19","19",32,0.0061837831293175,5174.82572250748,"11"
"371830510001005","4","5","5","14","4","5","5","14","4","18","18",177,0.017401426056435,10171.5801581989,"147"
"371830518002005","5","4","5","14","5","4","5","14","5","19","19",11,0.00817764986523506,1345.12973547123,"2"
"371830518001024","4","4","5","13","4","4","5","13","3","16","16",16,0.0393787671485525,406.310333171214,"8"
"371830542081084","1","2","1","4","1","2","1","4","2","6","6",0,0.0327273721582831,0,"0"
"371830541102054","1","2","1","4","2","2","2","6","3","7","9",1,0.00200048267740706,499.879359763394,"1"
"371830515022000","5","4","4","13","5","4","5","14","3","16","17",61,0.0243141528421306,2508.82687116705,"25"
"371830518002007","5","4","5","14","5","4","5","14","4","18","18",47,0.0110204142858412,4264.81244542544,"26"
"371830541051017","4","2","2","8","4","2","2","8","4","12","12",77,0.00891399615171475,8638.10110409211,"21"
"371830541061019","1","2","3","6","1","2","3","6","3","9","9",0,0.00234388147789389,0,"0"
"371830541102047","1","1","1","3","2","1","1","4","2","5","6",99,0.0175037510580186,5655.93053008186,"29"
"371830542091039","5","4","1","10","5","4","1","10","5","15","15",6,0.00523520971296679,1146.0858932048,"2"
"371830523012002","5","5","4","14","5","5","4","14","5","19","19",87,0.00576509857947086,15090.8087347893,"40"
"371830504001014","3","4","5","12","4","4","5","13","3","15","16",0,0.00519103324835428,0,"0"
"371830524012013","2","5","4","11","2","5","4","11","4","15","15",0,0.00283602280266321,0,"0"
"371830541062037","4","2","2","8","4","3","2","9","5","13","14",44,0.188047207030691,233.9837995723,"20"
"371830541043025","1","3","3","7","5","4","3","12","3","10","15",128,0.0142675452357698,8971.41013992332,"37"
"371830528072078","3","1","1","5","3","2","1","6","2","7","8",79,0.0078786960811665,10027.039904337,"28"
"371830528062029","2","2","2","6","4","3","3","10","4","10","14",43,0.00284492539394022,15114.631860502,"10"
"371830541053018","3","2","1","6","3","2","2","7","4","10","11",106,0.00827700446836674,12806.5655159561,"56"
"371830505001029","5","4","5","14","5","4","5","14","4","18","18",147,0.023954759223891,6136.56762842313,"73"
"371830509001002","5","5","5","15","5","5","5","15","5","20","20",31,0.00471583013440607,6573.60403501987,"16"
"371830523021036","5","5","5","15","5","5","5","15","5","20","20",0,0.0072817507862684,0,"0"
"371830510002030","5","5","5","15","5","5","5","15","5","20","20",0,0.00307325461203017,0,"0"
"371830526011024","4","3","4","11","4","3","5","12","4","15","16",15,0.00261261630567563,5741.37119461977,"5"
"371830526012022","5","4","4","13","5","4","5","14","4","17","18",29,0.00712430257127569,4070.57388563541,"12"
"371830501001031","4","5","5","14","5","5","5","15","3","17","18",306,0.0115327632680577,26533.1033757997,"233"
"371830541063020","5","4","3","12","5","4","3","12","5","17","17",445,0.107828101600928,4126.93902046933,"174"
"371830527073017","4","4","3","11","4","4","4","12","2","13","14",39,0.0262276128363642,1486.98245026429,"17"
"371830541061011","1","1","2","4","1","1","3","5","2","6","7",0,0.0122464498732558,0,"0"
"371830540072018","1","2","3","6","2","2","3","7","5","11","12",74,0.0124048329441557,5965.4168930073,"24"
"371830528072062","2","1","1","4","5","5","2","12","2","6","14",34,0.32195407798067,105.605122982916,"12"
"371830528031020","2","2","4","8","2","2","4","8","3","11","11",0,0.0314692584981372,0,"0"
"371830527063008","2","2","3","7","2","2","4","8","3","10","11",141,0.0848916023545016,1660.94167254841,"65"
"371830528062014","4","3","3","10","4","3","4","11","3","13","14",1,0.0017540941872454,570.094814332852,"1"
"371830525052009","1","3","3","7","1","3","3","7","3","10","10",1,0.00400068553241687,249.95716156573,"1"
"371830541055009","2","3","2","7","2","3","3","8","3","10","11",15,0.0219504883808034,683.356093940858,"6"
"371830518002004","5","4","5","14","5","4","5","14","5","19","19",0,0.00759914628671049,0,"0"
"371830536101045","1","1","1","3","1","1","1","3","1","4","4",299,0.0586705199802088,5096.25617943834,"154"
"371830510001021","5","5","5","15","5","5","5","15","4","19","19",0,0.003837032138215,0,"0"
"371830527071008","2","3","3","8","2","3","3","8","2","10","10",87,0.00997513069302746,8721.69023918778,"28"
"371830520011005","1","3","4","8","3","3","4","10","4","12","14",0,0.00410874513722797,0,"0"
"371830537093041","1","5","1","7","1","5","1","7","3","10","10",0,0.0131527004116572,0,"0"
"371830537171041","3","5","2","10","3","5","2","10","2","12","12",0,0.00374058708615758,0,"0"
"371830525051028","4","4","4","12","4","4","4","12","5","17","17",161,0.0133369331643759,12071.7407829594,"76"
"371830537072009","3","2","3","8","3","2","4","9","4","12","13",109,0.0387455050953397,2813.22955351305,"40"
"371830537241088","4","5","3","12","4","5","3","12","2","14","14",0,0.000437620187561741,0,"0"
"371830540161007","5","5","4","14","5","5","4","14","5","19","19",177,0.0740934870243046,2388.87393627377,"56"
"371830537222007","2","2","2","6","2","2","3","7","3","9","10",721,0.0932153677383866,7734.77611571003,"419"
"371830541051035","4","4","2","10","4","4","3","11","4","14","15",77,0.00561068432431954,13723.8161245756,"45"
"371830541051015","4","2","2","8","4","2","2","8","4","12","12",65,0.00495312196742752,13123.0364258037,"15"
"371830525072011","2","5","2","9","2","5","2","9","3","12","12",0,0.0490233628752387,0,"0"
"371830540162004","5","5","3","13","5","5","4","14","2","15","16",860,0.649848280051445,1323.38582158272,"404"
"371830527013024","3","2","4","9","3","3","5","11","4","13","15",0,0.0574172845306114,0,"0"
"371830540141076","1","2","1","4","1","3","2","6","3","7","9",213,0.0592378601198382,3595.673435352,"60"
"371830540161003","3","5","3","11","3","5","3","11","4","15","15",16,0.00207541553629747,7709.29952107032,"10"
"371830507003027","5","5","5","15","5","5","5","15","4","19","19",24,0.0164163616643279,1461.95609543319,"8"
"371830526011032","4","3","4","11","4","3","4","11","5","16","16",0,0.00427761383481683,0,"0"
"371830537252049","1","5","2","8","1","5","2","8","3","11","11",0,0.00302176169489424,0,"0"
"371830541054013","2","3","2","7","3","3","3","9","3","10","12",362,0.0695283172741253,5206.51173784004,"141"
"371830537131016","4","5","2","11","4","5","2","11","4","15","15",0,0.0548484403077551,0,"0"
"371830537111007","1","5","1","7","1","5","1","7","2","9","9",419,0.315176398686992,1329.41426371242,"140"
"371830525043038","3","5","3","11","3","5","4","12","3","14","15",29,0.00429642954032366,6749.79066404412,"17"
"371830541103012","1","1","1","3","1","2","1","4","3","6","7",107,0.0743286144437764,1439.55327030799,"43"
"371830525071004","2","2","2","6","2","2","2","6","4","10","10",74,0.0266558135823715,2776.1298589265,"31"
"371830537223000","4","2","3","9","4","3","3","10","2","11","12",428,0.110940204210629,3857.93412807683,"193"
"371830537222003","2","2","3","7","2","2","3","7","3","10","10",126,0.0320474369708433,3931.67166892737,"50"
"371830537224005","5","1","3","9","5","1","3","9","4","13","13",146,0.00869343357619173,16794.2848726472,"99"
"371830527063001","4","3","3","10","4","3","4","11","3","13","14",3,0.00496168885863183,604.632834801987,"1"
"371830527072012","3","4","3","10","3","4","4","11","2","12","13",83,0.0302461342003027,2744.15234192703,"34"
"371830523012004","5","5","4","14","5","5","4","14","5","19","19",0,0.00109251029772565,0,"0"
"371830523011004","5","5","4","14","5","5","4","14","5","19","19",34,0.0184089407695909,1846.92864329073,"17"
"371830511022011","4","5","5","14","4","5","5","14","5","19","19",0,0.00713865479895898,0,"0"
"371830542071044","1","4","1","6","1","4","1","6","2","8","8",69,0.0110166485350322,6263.24782719394,"18"
"371830542091016","1","1","1","3","1","1","1","3","3","6","6",67,0.0690059348641705,970.930980529154,"21"
"371830545002008","4","4","4","12","4","4","5","13","4","16","17",0,0.00151275605027373,0,"0"
"371830545003002","1","4","3","8","1","4","3","8","3","11","11",42,0.0091016917985168,4614.52671983952,"20"
"371830521013011","3","3","4","10","3","3","5","11","3","13","14",31,0.00666561240581017,4650.73546325292,"13"
"371830545002024","3","4","4","11","3","4","5","12","5","16","17",0,0.00636066365124472,0,"0"
"371830520023005","5","4","4","13","5","5","5","15","5","18","20",37,0.00941959131595559,3927.98357794214,"17"
"371830520022009","4","4","5","13","4","4","5","13","5","18","18",25,0.00567207265321944,4407.55990419307,"12"
"371830520022008","5","4","5","14","5","4","5","14","5","19","19",136,0.0215953234105978,6297.65979486369,"44"
"371830520012004","2","5","4","11","5","5","5","15","4","15","19",22,0.0298055542890199,738.117459137628,"7"
"371830520021017","4","4","4","12","5","5","5","15","5","17","20",40,0.00863565264167375,4631.9602767449,"15"
"371830526023001","3","3","4","10","3","3","4","10","3","13","13",96,0.0243028935752009,3950.14691164019,"44"
"371830524091001","5","5","4","14","5","5","5","15","4","18","19",641,0.0313331078938919,20457.5939983584,"267"
"371830527062000","5","3","4","12","5","3","4","12","3","15","15",45,0.0293791815977581,1531.69685310206,"20"
"371830506003019","5","5","5","15","5","5","5","15","5","20","20",36,0.00414018636922399,8695.2607417882,"12"
"371830527013010","3","3","4","10","3","3","5","11","4","14","15",228,0.148506923649656,1535.28195451599,"88"
"371830528064018","2","1","1","4","2","2","2","6","4","8","10",202,0.0199461330105184,10127.2762942811,"48"
"371830545002028","3","3","4","10","3","3","4","10","3","13","13",0,0.223815399095469,0,"0"
"371830521011007","3","3","4","10","3","3","4","10","3","13","13",127,0.0133464070821483,9515.66958944863,"31"
"371830527012033","2","3","4","9","2","3","5","10","4","13","14",0,0.0301847773108258,0,"0"
"371830527061002","4","3","3","10","4","3","4","11","3","13","14",110,0.0110880354005059,9920.60324726068,"43"
"371830524012007","4","5","4","13","4","5","5","14","4","17","18",0,0.0129013033464539,0,"0"
"371830510002016","5","5","5","15","5","5","5","15","5","20","20",0,0.00195511799315043,0,"0"
"371830511023008","5","5","5","15","5","5","5","15","5","20","20",0,0.0056959855539626,0,"0"
"371830537122012","3","2","2","7","3","2","3","8","4","11","12",207,0.114987558596767,1800.19475607704,"81"
"371830537131008","5","3","3","11","5","3","3","11","5","16","16",41,0.00498156526752908,8230.34484105766,"32"
"371830541102032","1","1","1","3","3","1","1","5","2","5","7",0,0.00168984073060269,0,"0"
"371830537111035","4","1","2","7","4","1","2","7","4","11","11",0,0.00385721703810929,0,"0"
"371830537171040","1","1","1","3","1","1","1","3","1","4","4",0,0.00831179314671344,0,"0"
"371830545002042","1","2","3","6","1","2","3","6","3","9","9",0,0.0463570691460604,0,"0"
"371830537211025","4","5","2","11","4","5","2","11","2","13","13",44,0.088004861633113,499.972378610552,"15"
"371830540122003","4","5","4","13","4","5","4","13","2","15","15",51,0.0140887629519927,3619.90617443007,"19"
"371830540141031","3","2","1","6","3","3","2","8","5","11","13",137,0.0111225859602547,12317.2794968323,"45"
"371830505001007","5","4","5","14","5","5","5","15","3","17","18",49,0.00830094337949843,5902.94352820423,"27"
"371830521014025","4","4","5","13","4","4","5","13","4","17","17",55,0.0115301088287152,4770.11976357284,"23"
"371830528064000","2","1","2","5","2","2","2","6","5","10","11",146,0.0995572288466729,1466.49320889449,"47"
"371830515012023","5","4","4","13","5","4","5","14","3","16","17",50,0.014128319318013,3538.99136015791,"17"
"371830540141062","3","2","1","6","3","3","2","8","5","11","13",149,0.0163852430761031,9093.54834151391,"43"
"371830540163015","2","4","3","9","2","4","3","9","4","13","13",65,0.00885616620488151,7339.51898555969,"22"
"371830525032025","4","5","3","12","4","5","4","13","3","15","16",125,0.0436520704311059,2863.55260507704,"67"
"371830525041002","2","5","4","11","2","5","4","11","5","16","16",82,0.0437750422314412,1873.21349837794,"34"
"371830541044006","3","3","3","9","3","3","3","9","2","11","11",0,0.00154484961389973,0,"0"
"371830525032008","3","5","3","11","3","5","3","11","3","14","14",40,0.0222591906764283,1797.01052843572,"14"
"371830524011062","2","5","3","10","3","5","4","12","4","14","16",27,0.00841979239305472,3206.72989779079,"15"
"371830541053011","4","2","1","7","4","2","1","7","4","11","11",256,0.012866283160963,19896.9661088075,"140"
"371830528072082","4","2","1","7","4","4","2","10","2","9","12",30,0.00408057976833454,7351.89647137919,"10"
"371830527051012","5","2","4","11","5","3","4","12","3","14","15",64,0.0458033780490773,1397.27685437143,"26"
"371830528062037","1","1","1","3","5","3","3","11","4","7","15",16,0.0102207520652836,1565.44253278058,"3"
"371830540043004","4","4","4","12","4","4","4","12","2","14","14",78,0.028016927063097,2784.03123313046,"45"
"371830540171054","2","4","2","8","2","4","3","9","2","10","11",0,0.00743777890571835,0,"0"
"371830520012016","4","4","5","13","4","5","5","14","3","16","17",0,0.00100443161787653,0,"0"
"371830528062052","3","1","2","6","3","2","3","8","3","9","11",542,0.0889507458801899,6093.25975444921,"186"
"371830527073020","2","3","3","8","2","3","3","8","2","10","10",109,0.0129733370871786,8401.84751753069,"40"
"371830521014024","4","4","5","13","4","4","5","13","4","17","17",37,0.00731711688947324,5056.63645379644,"13"
"371830542071077","1","2","1","4","1","2","1","4","2","6","6",6,0.0501846371981473,119.558501066966,"2"
"371830542071057","1","2","1","4","1","2","1","4","2","6","6",377,0.0497291167720468,7581.07170348771,"142"
"371830540141081","1","2","1","4","1","3","2","6","3","7","9",171,0.0386550791990233,4423.73948115778,"52"
"371830527041003","2","2","3","7","2","2","4","8","2","9","10",0,0.0298352999085255,0,"0"
"371830540182002","1","3","3","7","1","4","3","8","2","9","10",1130,0.348657628594643,3241.00179466821,"559"
"371830538084018","3","3","3","9","3","3","3","9","4","13","13",2,0.0881037855463898,22.7005001839215,"2"
"371830538084023","2","4","3","9","2","4","3","9","3","12","12",0,0.0019708591095815,0,"0"
"371830538071011","4","2","2","8","4","2","3","9","3","11","12",77,0.0124102894488787,6204.52893682968,"31"
"371830538071022","3","2","3","8","3","2","3","8","3","11","11",44,0.00454971056764611,9670.94485369964,"25"
"371830507003036","5","5","5","15","5","5","5","15","4","19","19",20,0.00227663123860672,8784.90976528979,"6"
"371830524012014","4","5","4","13","4","5","5","14","5","18","19",0,0.00430063891807105,0,"0"
"371830528062008","3","3","3","9","3","4","4","11","3","12","14",0,0.00292615390161744,0,"0"
"371830541102052","1","1","1","3","3","1","1","5","2","5","7",70,0.0124729257990208,5612.15557022681,"23"
"371830536101072","2","5","1","8","2","5","1","8","1","9","9",50,0.00817373244173142,6117.15643452218,"31"
"371830542091084","5","4","1","10","5","4","1","10","4","14","14",3,0.258763156728067,11.5936133950966,"1"
"371830524062029","1","5","3","9","2","5","3","10","3","12","13",2,0.00393283580490182,508.538901498821,"1"
"371830536101012","2","5","1","8","2","5","1","8","1","9","9",41,0.0127447302570015,3217.01590957377,"16"
"371830541054009","2","3","2","7","3","3","3","9","3","10","12",0,0.00327568811034395,0,"0"
"371830528061006","2","1","1","4","2","1","1","4","4","8","8",133,0.0320236303457535,4153.18308898842,"49"
"371830540141037","2","3","1","6","2","4","2","8","3","9","11",423,0.204094366908422,2072.57067604322,"147"
"371830527063015","2","3","3","8","2","3","4","9","3","11","12",10,0.00607911723417104,1644.97567899982,"3"
"371830540121012","3","4","3","10","3","4","4","11","2","12","13",344,0.141298788659176,2434.55731832038,"127"
"371830504002012","5","4","5","14","5","5","5","15","4","18","19",0,0.0036514458815303,0,"0"
"371830525072019","2","2","2","6","2","2","2","6","4","10","10",34,0.00898447245136842,3784.30677861575,"13"
"371830540082005","3","3","3","9","3","3","3","9","2","11","11",362,0.0204305264357556,17718.5840579449,"175"
"371830520022003","5","4","5","14","5","4","5","14","5","19","19",155,0.0350367991974341,4423.92009402934,"47"
"371830528061025","5","5","4","14","5","5","5","15","5","19","20",0,0.00190633048436012,0,"0"
"371830541055001","4","3","2","9","4","3","3","10","5","14","15",37,0.032860174757117,1125.98305619133,"15"
"371830541053002","1","2","2","5","1","2","2","5","5","10","10",0,0.00682832513128583,0,"0"
"371830527012013","2","2","4","8","2","3","4","9","2","10","11",352,0.00994674821581997,35388.4498091704,"157"
"371830541132011","1","1","1","3","1","1","1","3","2","5","5",18,0.0680635931658097,264.458562393998,"4"
"371830501001084","5","5","5","15","5","5","5","15","5","20","20",3,0.0189677553220949,158.163153681416,"2"
"371830530081009","1","3","2","6","2","4","2","8","3","9","11",0,0.00994405110679344,0,"0"
"371830524061000","2","4","3","9","3","4","4","11","3","12","14",135,0.0337265732111918,4002.77843689146,"73"
"371830524012015","5","5","4","14","5","5","5","15","5","19","20",0,0.00528205937738013,0,"0"
"371830524072024","4","5","4","13","4","5","4","13","3","16","16",0,0.0091384753076265,0,"0"
"371830538081019","1","1","1","3","1","1","1","3","3","6","6",0,0.0114903897594034,0,"0"
"371830525043023","4","5","3","12","4","5","4","13","3","15","16",0,0.000430999609946239,0,"0"
"371830530031002","1","3","2","6","2","4","2","8","3","9","11",0,0.00474913545727524,0,"0"
"371830541063014","3","3","2","8","3","3","3","9","4","12","13",32,0.0245225273671858,1304.9225930448,"10"
"371830542102030","2","1","1","4","2","2","1","5","3","7","8",217,0.0239560591851557,9058.25112230745,"76"
"371830541053019","4","3","2","9","4","3","2","9","5","14","14",310,0.0461658775901424,6714.91621478876,"145"
"371830537131011","3","2","3","8","3","2","3","8","5","13","13",41,0.00272640768510988,15038.1031508674,"30"
"371830537122011","3","2","3","8","3","2","3","8","4","12","12",178,0.0825483919176023,2156.31093307881,"64"
"371830537132019","4","3","3","10","4","3","3","10","4","14","14",120,0.00562954660139583,21316.1038528833,"59"
"371830536102032","5","5","2","12","5","5","2","12","1","13","13",36,0.00310982345785886,11576.2198362174,"22"
"371830536102111","5","5","2","12","5","5","2","12","1","13","13",41,0.00343300492184348,11942.8899560049,"18"
"371830540143025","2","3","2","7","2","4","3","9","2","9","11",0,0.00644866794543665,0,"0"
"371830536101036","2","1","1","4","2","1","1","4","1","5","5",676,0.266326714055119,2538.23579958297,"279"
"371830540151000","2","2","2","6","2","2","2","6","3","9","9",93,0.0685977219234528,1355.73015243534,"34"
"371830542071093","2","4","1","7","2","5","1","8","3","10","11",15,0.00995447419900168,1506.86010131046,"6"
"371830521012015","5","4","5","14","5","4","5","14","3","17","17",105,0.0190821756431527,5502.5172162524,"39"
"371830528063011","2","1","1","4","2","1","2","5","3","7","8",937,0.180679993836816,5185.96431238682,"360"
"371830541041008","1","3","1","5","3","4","2","9","5","10","14",315,0.0563548281314878,5589.58319001591,"113"
"371830515021003","3","5","4","12","3","5","5","13","5","17","18",200,0.234378314222949,853.321266786452,"86"
"371830517003018","2","3","4","9","5","3","5","13","4","13","17",8,0.0247213350269101,323.607118761657,"4"
"371830527063030","1","1","2","4","1","1","3","5","3","7","8",0,0.00650508420020716,0,"0"
"371830504001002","2","3","4","9","2","4","5","11","3","12","14",0,0.00713362214359885,0,"0"
"371830521021029","5","4","4","13","5","4","5","14","3","16","17",89,0.0195673143056594,4548.40141113585,"31"
"371830527041000","3","3","4","10","3","3","4","10","2","12","12",203,0.0323053548465292,6283.78796531963,"68"
"371830540141091","2","2","2","6","2","2","2","6","3","9","9",0,0.00703321981286104,0,"0"
"371830540042003","3","2","4","9","3","3","4","10","2","11","12",564,0.180265371995179,3128.72069525968,"273"
"371830540141073","1","3","1","5","2","4","2","8","4","9","12",143,0.0499926496006853,2860.42050465834,"42"
"371830511022003","4","5","5","14","4","5","5","14","5","19","19",0,0.0440256409761938,0,"0"
"371830524071014","2","5","4","11","3","5","4","12","3","14","15",246,0.0296652005215977,8292.54465416137,"122"
"371830509003003","5","5","5","15","5","5","5","15","5","20","20",88,0.0132995884810046,6616.74608396252,"35"
"371830538082012","3","1","2","6","3","2","3","8","3","9","11",3,0.0217620275753952,137.854801883989,"2"
"371830523012001","5","5","4","14","5","5","4","14","5","19","19",561,0.0477214197231638,11755.7273705269,"286"
"371830527073002","3","3","3","9","3","4","4","11","2","11","13",10,0.00582017309617348,1718.16195751542,"4"
"371830541054024","3","4","3","10","3","4","3","10","3","13","13",445,0.0483337375158528,9206.81956064428,"135"
"371830528072081","3","1","1","5","5","5","2","12","2","7","14",35,0.0193935580667352,1804.72298479533,"14"
"371830541054006","4","3","2","9","4","3","3","10","3","12","13",60,0.0211109479296968,2842.12723179511,"20"
"371830542081083","1","2","1","4","1","2","1","4","2","6","6",0,0.00243913052480282,0,"0"
"371830541102028","2","1","1","4","2","1","1","4","3","7","7",178,0.0347947052197166,5115.72087982901,"65"
"371830523012003","4","5","4","13","4","5","4","13","5","18","18",377,0.108006666208045,3490.52529103911,"216"
"371830542081097","1","2","1","4","1","2","1","4","2","6","6",0,0.000125641788737386,0,"0"
"371830521021006","4","3","4","11","4","4","4","12","4","15","16",139,0.0104723894678389,13272.9975739418,"33"
"371830521021017","3","3","4","10","3","4","5","12","4","14","16",0,0.00515614106137225,0,"0"
"371830509002007","5","5","5","15","5","5","5","15","5","20","20",158,0.00972647069465885,16244.3300309087,"70"
"371830515011025","5","3","4","12","5","3","5","13","4","16","17",33,0.0136495472714598,2417.66260401915,"16"
"371830530081019","2","3","2","7","2","4","2","8","3","10","11",460,0.176149394233284,2611.41970996958,"232"
"371830528063020","2","1","2","5","2","2","2","6","5","10","11",13,0.00914700077977633,1421.2308835419,"4"
"371830511011000","3","4","4","11","3","5","5","13","5","16","18",0,0.0484166633616009,0,"0"
"371830542091076","3","1","1","5","3","1","1","5","3","8","8",15,0.00904153191021241,1659.01090091354,"5"
"371830541103007","1","1","1","3","1","2","1","4","3","6","7",239,0.03902323575115,6124.55618811561,"67"
"371830521022006","4","2","4","10","4","2","4","10","3","13","13",0,0.0140915276675053,0,"0"
"371830509002003","5","5","5","15","5","5","5","15","5","20","20",41,0.00361412243555872,11344.3860110018,"12"
"371830521021025","2","3","4","9","2","4","4","10","3","12","13",0,0.0149340823544733,0,"0"
"371830537224000","4","1","3","8","4","2","3","9","3","11","12",185,0.0574631525088501,3219.45441422671,"70"
"371830537171023","1","5","1","7","2","5","1","8","1","8","9",42,0.00443307921446195,9474.22727367114,"25"
"371830537241080","2","5","2","9","2","5","2","9","3","12","12",44,0.00278354271296747,15807.1941181361,"23"
"371830525041001","2","5","3","10","2","5","4","11","4","14","15",2351,0.325471892074389,7223.35801416197,"809"
"371830525033025","3","5","3","11","3","5","3","11","4","15","15",94,0.00743785805556741,12638.0470422716,"59"
"371830525043031","4","5","3","12","4","5","3","12","4","16","16",288,0.111960570977951,2572.33414839155,"198"
"371830525032012","3","5","3","11","3","5","3","11","3","14","14",29,0.0120704530527407,2402.56102014458,"9"
"371830537142013","4","3","3","10","4","3","3","10","4","14","14",50,0.0225437995605582,2217.90474430398,"21"
"371830525072002","3","5","2","10","3","5","2","10","4","14","14",0,0.018594916683754,0,"0"
"371830537093052","2","5","1","8","2","5","1","8","2","10","10",64,0.02543424387128,2516.29261415819,"24"
"371830537093029","1","5","1","7","1","5","1","7","2","9","9",14,0.0122553536577944,1142.35789442894,"7"
"371830537191001","1","1","1","3","2","1","1","4","1","4","5",332,0.0461840608379048,7188.62728778316,"120"
"371830537241073","3","5","2","10","3","5","2","10","3","13","13",190,0.0195457306040276,9720.7929367884,"72"
"371830537171026","1","5","1","7","3","5","2","10","1","8","11",99,0.0062206213035667,15914.8090148546,"59"
"371830537181023","1","1","1","3","4","1","1","6","1","4","7",33,0.00703611999097591,4690.08488233909,"13"
"371830540083000","4","3","3","10","4","4","3","11","2","12","13",94,0.051299450465036,1832.37830323479,"37"
"371830541042029","2","2","1","5","2","2","2","6","5","10","11",38,0.0217779334148043,1744.88548918825,"14"
"371830527041013","3","2","4","9","3","3","4","10","2","11","12",579,0.078858521543114,7342.26293709356,"178"
"371830540141070","2","3","1","6","2","4","2","8","5","11","13",7,0.00148749692039698,4705.8920956501,"2"
"371830540162027","2","4","3","9","2","5","3","10","4","13","14",60,0.0121650985235175,4932.14254566114,"24"
"371830540044001","2","3","4","9","2","3","4","9","2","11","11",1146,0.0861065105514806,13309.0981467056,"396"
"371830540081011","5","4","3","12","5","4","4","13","2","14","15",93,0.0147091636936434,6322.58923328118,"32"
"371830540131003","2","5","2","9","2","5","2","9","3","12","12",47,0.0122714092612182,3830.04095124885,"16"
"371830525072028","1","1","2","4","1","1","2","4","5","9","9",40,0.013876600594765,2882.55035711629,"16"
"371830525072026","1","1","2","4","1","1","2","4","5","9","9",101,0.0351230705984224,2875.60279551801,"43"
"371830525071007","2","2","2","6","2","2","2","6","5","11","11",28,0.00996800789091633,2808.98654038145,"11"
"371830525061005","5","3","3","11","5","3","3","11","4","15","15",50,0.0585499332065365,853.971939192888,"27"
"371830537251020","3","5","2","10","3","5","2","10","3","13","13",2,0.000857120419291899,2333.39441574881,"1"
"371830524011042","1","5","2","8","1","5","3","9","4","12","13",31,0.003126924466512,9913.89473330633,"23"
"371830525043007","5","3","4","12","5","3","4","12","5","17","17",18,0.0281760142407233,638.841244407958,"8"
"371830524011049","1","5","2","8","1","5","3","9","5","13","14",8,0.0309785410674201,258.243278228927,"4"
"371830525031003","1","5","2","8","1","5","2","8","3","11","11",103,0.0262951158357012,3917.07724900591,"88"
"371830501001104","5","5","5","15","5","5","5","15","5","20","20",127,0.0086906176867037,14613.460697311,"83"
"371830524011083","2","5","3","10","2","5","4","11","4","14","15",9,0.134144123257383,67.0920185055862,"3"
"371830525031005","1","5","2","8","1","5","2","8","4","12","12",11,0.0247981662312816,443.581186504189,"4"
"371830536102025","4","5","2","11","4","5","2","11","1","12","12",0,0.0092301814513179,0,"0"
"371830537171010","2","5","1","8","2","5","1","8","2","10","10",102,0.0155618988512418,6554.47005375315,"49"
"371830537113020","5","5","3","13","5","5","3","13","4","17","17",1,0.00204848320086084,488.166073111934,"1"
"371830537252016","4","5","3","12","4","5","3","12","4","16","16",17,0.0438149548329975,387.995378856287,"8"
"371830537261001","3","5","3","11","3","5","3","11","4","15","15",442,0.0861927256861692,5128.04295816491,"173"
"371830537251019","3","5","2","10","3","5","2","10","4","14","14",79,0.0110077923899654,7176.73418986497,"31"
"371830537192007","1","1","1","3","2","1","1","4","1","4","5",418,0.0502796928683952,8313.49549198909,"148"
"371830524012006","2","5","3","10","2","5","4","11","3","13","14",0,0.397577663189205,0,"0"
"371830540143005","2","2","1","5","2","3","2","7","3","8","10",68,0.0370241881628968,1836.63716543406,"25"
"371830540171022","2","4","3","9","2","4","3","9","2","11","11",69,0.0262460511872285,2628.96690659415,"36"
"371830524093004","5","5","4","14","5","5","5","15","4","18","19",93,0.0111826270352217,8316.47158642417,"49"
"371830528033067","1","1","2","4","1","1","2","4","2","6","6",0,0.0797676855359922,0,"0"
"371830508001019","5","5","5","15","5","5","5","15","4","19","19",123,0.0107871774885581,11402.4266431572,"48"
"371830536101090","1","5","1","7","1","5","2","8","1","8","9",0,0.0238616035087556,0,"0"
"371830523011008","4","5","3","12","4","5","3","12","4","16","16",165,0.297410764319948,554.788258512716,"106"
"371830545002082","3","4","4","11","3","4","4","11","4","15","15",52,0.00998854859408611,5205.96155789716,"18"
"371830530031004","1","3","2","6","2","4","2","8","3","9","11",0,0.00311836898317526,0,"0"
"371830528033007","2","2","2","6","3","3","3","9","4","10","13",0,0.005759292041099,0,"0"
"371830515012004","4","3","4","11","4","3","5","12","3","14","15",0,0.0025494929154258,0,"0"
"371830540121002","3","4","3","10","3","4","4","11","2","12","13",88,0.0368595964365298,2387.43796751902,"31"
"371830537142014","4","3","3","10","4","3","3","10","4","14","14",46,0.020104833593255,2288.00700023861,"19"
"371830528033052","1","1","2","4","1","2","2","5","3","7","8",16,0.00697620147815465,2293.5117413255,"5"
"371830542081122","2","4","1","7","2","5","1","8","3","10","11",299,0.123150667517391,2427.92025433216,"112"
"371830525061017","4","2","3","9","4","3","3","10","4","13","14",59,0.038494479635603,1532.68729850375,"26"
"371830528072069","4","1","1","6","4","3","2","9","2","8","11",22,0.00335127385644003,6564.6679270103,"7"
"371830525061004","4","3","3","10","4","3","3","10","4","14","14",66,0.034006463670644,1940.80750763198,"30"
"371830524011013","1","5","3","9","1","5","3","9","5","14","14",2,0.349655280908298,5.7199193297027,"1"
"371830525032020","3","5","3","11","3","5","3","11","3","14","14",112,0.0615633456384716,1819.26435021442,"41"
"371830524011080","1","5","2","8","1","5","2","8","3","11","11",0,0.00577208926216836,0,"0"
"371830525032016","3","5","3","11","3","5","3","11","3","14","14",16,0.00606368822807903,2638.6580902872,"6"
"371830525041018","1","5","3","9","1","5","4","10","5","14","15",0,0.00518921441788228,0,"0"
"371830524011046","1","5","2","8","1","5","3","9","4","12","13",124,0.00534483580636029,23199.9643192858,"66"
"371830524011047","1","5","2","8","1","5","3","9","5","13","14",0,0.000870878390389692,0,"0"
"371830524011095","1","5","2","8","1","5","3","9","3","11","12",2,0.010005040640853,199.899237973458,"1"
"371830536101041","2","1","1","4","2","1","1","4","1","5","5",37,0.00300781294367,12301.2968867852,"19"
"371830542071068","1","4","1","6","1","4","1","6","2","8","8",369,0.115854661572369,3185.02505632459,"112"
"371830541103017","1","1","1","3","2","2","1","5","2","5","7",83,0.079088630970802,1049.45551568141,"28"
"371830541102018","1","1","1","3","1","2","2","5","3","6","8",25,0.00403009215040491,6203.33209936359,"7"
"371830525043018","5","5","4","14","5","5","4","14","4","18","18",0,0.00034468608775033,0,"0"
"371830525051021","4","3","3","10","4","3","4","11","5","15","16",70,0.0225343275685861,3106.3718137116,"27"
"371830515012012","4","2","3","9","4","2","4","10","4","13","14",0,0.0239372913121686,0,"0"
"371830521021011","3","3","4","10","3","3","4","10","5","15","15",106,0.0438126223512318,2419.39409949562,"26"
"371830521014012","4","5","5","14","4","5","5","14","5","19","19",88,0.0506251470624688,1738.2665553823,"30"
"371830521014018","4","5","5","14","4","5","5","14","5","19","19",37,0.00790678114885622,4679.52752244222,"16"
"371830506002023","5","4","5","14","5","4","5","14","3","17","17",17,0.00793843689451313,2141.47951616899,"5"
"371830519001033","5","4","5","14","5","4","5","14","3","17","17",19,0.015196955087341,1250.25045417334,"8"
"371830537223005","3","2","2","7","3","2","2","7","3","10","10",0,0.011264865552749,0,"0"
"371830523023018","2","5","3","10","4","5","3","12","3","13","15",123,0.0145265005516852,8467.28360780125,"54"
"371830520012007","3","4","5","12","4","4","5","13","3","15","16",241,0.347347001741597,693.830661533356,"83"
"371830521014023","3","5","5","13","3","5","5","13","4","17","17",0,0.00289381592308467,0,"0"
"371830508002003","5","5","5","15","5","5","5","15","5","20","20",154,0.0324059673802953,4752.21116508439,"39"
"371830515022028","5","5","5","15","5","5","5","15","4","19","19",0,0.00572161822605,0,"0"
"371830516004009","5","4","5","14","5","4","5","14","3","17","17",29,0.0106381184442673,2726.04597814264,"11"
"371830514001003","5","5","5","15","5","5","5","15","4","19","19",41,0.010566989412163,3880.00767302819,"20"
"371830540072005","2","2","3","7","3","3","3","9","5","12","14",4,0.00214629769044197,1863.67437183251,"2"
"371830528061004","3","1","1","5","3","2","2","7","4","9","11",0,0.000677055837243451,0,"0"
"371830528033000","1","2","2","5","5","3","3","11","3","8","14",743,0.146446071528388,5073.5399881039,"209"
"371830527052006","4","3","4","11","4","4","5","13","3","14","16",170,0.0161421688898499,10531.4224600199,"45"
"371830528064038","1","1","1","3","1","2","1","4","5","8","9",78,0.00900190276700686,8664.83475981101,"26"
"371830537192005","1","1","1","3","2","1","1","4","1","4","5",131,0.0209223163330696,6261.25701927862,"52"
"371830524081006","4","5","4","13","4","5","5","14","3","16","17",33,0.0132940970547711,2482.30472998966,"13"
"371830537262015","3","5","3","11","3","5","3","11","4","15","15",373,0.0754590820685383,4943.07629744568,"208"
"371830537151004","5","5","4","14","5","5","4","14","5","19","19",85,0.0260210291480219,3266.58870855851,"46"
"371830537071029","3","3","3","9","3","3","3","9","3","12","12",72,0.0344793020638556,2088.20932241192,"26"
"371830537231013","4","1","3","8","4","1","3","8","4","12","12",139,0.0377187610546405,3685.1687625328,"81"
"371839802001004","1","5","1","7","1","5","1","7","2","9","9",0,0.944807380439439,0,"0"
"371830528061005","2","1","1","4","2","2","1","5","4","8","9",0,0.00241474338714247,0,"0"
"371830536101042","3","1","1","5","3","1","1","5","1","6","6",48,0.00913868196008801,5252.39856356023,"12"
"371830536102038","4","5","2","11","4","5","2","11","1","12","12",0,0.0185139775461057,0,"0"
"371830540121008","2","4","3","9","2","4","4","10","3","12","13",453,0.0409719905260636,11056.3337095334,"211"
"371830540171002","3","5","3","11","3","5","3","11","2","13","13",0,0.11849399288783,0,"0"
"371830527041007","5","3","4","12","5","3","4","12","2","14","14",56,0.0168384020212299,3325.73126175483,"25"
"371830540043006","3","3","4","10","3","3","4","10","2","12","12",127,0.0334402749918493,3797.81565884116,"47"
"371830540133005","1","4","1","6","1","5","2","8","3","9","11",0,0.00265211659470185,0,"0"
"371830540143035","1","3","2","6","1","4","2","7","2","8","9",0,0.0010867041293773,0,"0"
"371830537241024","2","5","1","8","2","5","1","8","2","10","10",59,0.0432197833102339,1365.11559015682,"24"
"371830527043017","4","3","4","11","4","3","4","11","2","13","13",59,0.0138776967510592,4251.42594324934,"22"
"371830541062047","4","2","2","8","4","2","2","8","5","13","13",0,0.000148737448195561,0,"0"
"371830537192006","1","1","1","3","2","1","1","4","1","4","5",243,0.0450598804544308,5392.8238945451,"74"
"371830523011007","5","5","4","14","5","5","4","14","5","19","19",0,0.00111412818267011,0,"0"
"371830523011021","4","5","3","12","4","5","3","12","4","16","16",0,0.00295204317800361,0,"0"
"371830523013018","3","5","3","11","3","5","3","11","3","14","14",0,0.0172510205661848,0,"0"
"371830537171016","1","5","1","7","4","5","2","11","1","8","12",0,0.0226977929826459,0,"0"
"371830537121007","1","1","2","4","1","1","2","4","2","6","6",22,0.00770274805473037,2856.12353457276,"8"
"371830537211028","4","5","1","10","4","5","2","11","2","12","13",103,0.0600884707961543,1714.13914575094,"39"
"371830524011039","1","5","1","7","1","5","2","8","3","10","11",0,0.00281993515683546,0,"0"
"371830535211004","1","5","1","7","1","5","1","7","2","9","9",0,0.036876169042016,0,"0"
"371830528033058","1","1","2","4","1","1","2","4","3","7","7",0,0.00631447906050856,0,"0"
"371830537171014","1","1","1","3","1","1","1","3","1","4","4",0,0.0136423417718308,0,"0"
"371830528061022","1","1","2","4","1","2","3","6","5","9","11",0,0.0101173141017376,0,"0"
"371830545002064","2","2","3","7","2","2","3","7","2","9","9",0,0.00470124164695725,0,"0"
"371830537251012","3","5","2","10","3","5","2","10","4","14","14",35,0.00892858232269536,3919.99521704967,"18"
"371830540134037","1","4","1","6","1","4","1","6","5","11","11",34,0.00660673660674413,5146.2623718483,"17"
"371830537171005","1","5","1","7","1","5","2","8","2","9","10",351,0.783882534573886,447.771170448135,"139"
"371830537171043","2","5","1","8","2","5","1","8","2","10","10",85,0.017954833049018,4734.10138473266,"33"
"371830514003013","5","5","5","15","5","5","5","15","5","20","20",83,0.0129752239936173,6396.80671723499,"27"
"371830506003008","5","5","5","15","5","5","5","15","5","20","20",50,0.00559038056660765,8943.93492612274,"24"
"371830501001108","5","5","5","15","5","5","5","15","5","20","20",51,0.00840422438885368,6068.37676390936,"30"
"371830509002014","5","5","5","15","5","5","5","15","5","20","20",137,0.00515892824163299,26555.9033937318,"37"
"371830528032008","1","1","1","3","1","1","1","3","1","4","4",0,0.00883836187334537,0,"0"
"371830523021009","3","5","4","12","3","5","4","12","4","16","16",707,0.154843201774461,4565.90920297417,"314"
"371830520012023","3","4","4","11","3","4","5","12","4","15","16",60,0.0142323738682486,4215.74085640455,"28"
"371830527061040","3","3","4","10","3","3","5","11","5","15","16",0,0.0844893796329457,0,"0"
"371830524042001","3","5","4","12","3","5","4","12","4","16","16",297,0.0473765053635467,6268.93008931223,"114"
"371830537141001","2","2","2","6","2","2","3","7","3","9","10",0,0.0190620172807851,0,"0"
"371830545002061","1","2","3","6","1","2","3","6","2","8","8",0,0.00203678898892858,0,"0"
"371830528064061","3","1","1","5","3","4","2","9","3","8","12",105,0.0135215651525314,7765.37322532833,"31"
"371830521014003","4","4","5","13","4","4","5","13","5","18","18",0,0.00529283577710889,0,"0"
"371830527073035","1","3","3","7","1","3","3","7","2","9","9",110,0.0446705098828215,2462.47469054079,"49"
"371830541052010","3","3","2","8","3","3","2","8","3","11","11",110,0.0107315459390897,10250.1541366304,"38"
"371830527072013","4","3","2","9","4","3","3","10","2","11","12",337,0.108909458921948,3094.31341718001,"153"
"371830527063032","1","3","4","8","2","3","4","9","4","12","13",0,0.0823681479840776,0,"0"
"371830528061008","3","1","1","5","3","2","1","6","3","8","9",20,0.928830936021022,21.5324438758221,"6"
"371830530031077","1","3","2","6","1","3","2","6","3","9","9",13,0.0164077215463926,792.309886734894,"6"
"371830523021047","2","5","3","10","2","5","3","10","3","13","13",0,0.0162129550755935,0,"0"
"371830541055013","2","2","2","6","2","2","2","6","4","10","10",87,0.0416965831636997,2086.50190013029,"26"
"371830527061030","3","3","4","10","3","3","5","11","4","14","15",0,0.00523758617896967,0,"0"
"371830530081028","2","4","2","8","2","4","2","8","3","11","11",571,0.167170024328797,3415.68413531442,"309"
"371830519002007","4","4","5","13","4","5","5","14","4","17","18",113,0.027636578912373,4088.7839395132,"36"
"371830519003007","5","3","4","12","5","3","5","13","5","17","18",62,0.0141757747907211,4373.65864760934,"28"
"371830527063031","1","2","3","6","2","3","4","9","4","10","13",0,0.00762581489026218,0,"0"
"371830519003003","4","4","4","12","5","5","5","15","5","17","20",28,0.00767432864866738,3648.5276148373,"12"
"371830519001047","4","4","4","12","5","5","5","15","4","16","19",95,0.017942503749798,5294.69026869059,"40"
"371830537143013","3","3","3","9","3","3","3","9","3","12","12",113,0.0063172017988137,17887.6666598208,"68"
"371830541132041","5","3","2","10","5","4","2","11","5","15","16",106,0.00809943977924507,13087.3249124744,"50"
"371830527071006","2","3","3","8","3","3","3","9","2","10","11",33,0.0195855707621276,1684.91387873218,"17"
"371830541062000","2","2","2","6","2","2","3","7","3","9","10",0,0.151343896140561,0,"0"
"371830541063013","3","3","2","8","3","3","3","9","4","12","13",6,0.0301220479412301,199.189643801987,"2"
"371830541053022","3","2","1","6","3","2","2","7","4","10","11",103,0.00667139298051421,15439.0545274191,"40"
"371830537222011","2","2","3","7","2","2","3","7","3","10","10",343,0.0377319018795818,9090.45086289729,"185"
"371830540061002","2","2","3","7","2","2","3","7","4","11","11",201,0.0429734158817374,4677.31028301662,"29"
"371830537231012","3","1","2","6","3","2","3","8","3","9","11",115,0.00900477026436506,12771.0087679965,"54"
"371830527052024","2","2","4","8","2","3","5","10","4","12","14",0,0.00885622644759111,0,"0"
"371830528071003","1","1","1","3","1","1","1","3","5","8","8",3,0.175553651805252,17.0887929083241,"1"
"371830537093038","1","5","1","7","1","5","1","7","2","9","9",0,0.0233644162195536,0,"0"
"371830525072015","1","2","2","5","1","2","2","5","3","8","8",63,0.00668036969638783,9430.6157987132,"32"
"371830537092022","2","5","2","9","2","5","2","9","3","12","12",45,0.00227580359874548,19773.2352760168,"24"
"371830536102021","3","5","1","9","3","5","2","10","1","10","11",47,0.00506601544849607,9277.50822669772,"32"
"371830537261012","3","5","2","10","3","5","3","11","4","14","15",737,0.1344712045663,5480.72728564447,"363"
"371830528063000","2","1","1","4","2","2","2","6","5","9","11",34,0.0329469731651507,1031.96126180001,"11"
"371830528063021","2","1","2","5","2","2","2","6","5","10","11",0,0.00581419518543629,0,"0"
"371830541051020","4","2","2","8","4","2","2","8","4","12","12",201,0.0284695585841054,7060.17268958356,"55"
"371830504001029","4","5","5","14","5","5","5","15","3","17","18",0,0.0346147561695548,0,"0"
"371830525051000","2","2","3","7","2","2","3","7","3","10","10",965,0.371284741191323,2599.08337979,"429"
"371830527062011","3","2","4","9","3","2","4","9","3","12","12",254,0.00637068952651189,39870.0955278025,"139"
"371830524011021","3","5","1","9","3","5","1","9","3","12","12",0,0.00502031725250777,0,"0"
"371839802001011","1","5","1","7","1","5","1","7","2","9","9",3,0.983909266883893,3.04906163705644,"1"
"371839801001005","1","5","1","7","1","5","1","7","1","8","8",0,0.0237538380749048,0,"0"
"371830541054018","4","3","3","10","4","4","3","11","2","12","13",66,0.0481097289453691,1371.86389212349,"21"
"371830541131018","5","3","2","10","5","3","2","10","5","15","15",0,0.00267781083623385,0,"0"
"371830542091056","2","1","1","4","2","2","1","5","3","7","8",230,0.0806416501285717,2852.12417693955,"85"
"371830528062042","1","1","2","4","3","3","3","9","5","9","14",1,0.0426177654118818,23.4643930843263,"1"
"371830545001030","5","5","5","15","5","5","5","15","5","20","20",33,0.0045849306410475,7197.49164895996,"7"
"371830523013000","3","5","4","12","3","5","4","12","5","17","17",110,0.0124971708141098,8801.99219777053,"49"
"371830520022006","4","4","5","13","4","4","5","13","5","18","18",208,0.0381812946828991,5447.6937392372,"52"
"371830537111026","3","5","2","10","3","5","2","10","2","12","12",83,0.00741328567160792,11196.1151474145,"42"
"371830542091050","2","1","1","4","2","1","1","4","3","7","7",214,0.0388961406104413,5501.83120076838,"126"
"371830537181011","1","1","1","3","2","1","1","4","1","4","5",61,0.00630759530206992,9670.88043520833,"32"
"371830524072016","4","5","4","13","4","5","4","13","4","17","17",19,0.0111693438512267,1701.08470587672,"6"
"371830501001092","5","5","5","15","5","5","5","15","5","20","20",3,0.00520621660619292,576.234188264743,"2"
"371830527013016","3","2","4","9","3","3","5","11","4","13","15",0,0.101377077098791,0,"0"
"371830518001004","2","2","4","8","2","3","5","10","4","12","14",0,0.0805951285113176,0,"0"
"371830528062005","3","3","3","9","3","4","4","11","3","12","14",0,0.0016689570152114,0,"0"
"371830526031006","4","3","4","11","4","3","4","11","4","15","15",205,0.10679912174109,1919.49144017285,"79"
"371830530081007","1","3","2","6","2","4","2","8","2","8","10",0,0.0127054793711293,0,"0"
"371830523021015","3","5","4","12","3","5","5","13","5","17","18",0,0.000259659831082018,0,"0"
"371830526011012","4","4","4","12","4","4","4","12","4","16","16",98,0.0586526975987688,1670.85239063339,"36"
"371830524063005","1","5","2","8","3","5","2","10","2","10","12",0,0.000759516675331419,0,"0"
"371830542071038","2","4","1","7","2","4","1","7","3","10","10",58,0.00620392148815701,9348.92553213628,"33"
"371830517003019","3","3","4","10","5","3","5","13","4","14","17",0,0.000972947039842464,0,"0"
"371830537121006","3","1","2","6","3","1","2","6","3","9","9",244,0.0316532732697296,7708.52347309496,"127"
"371830528072072","4","2","1","7","4","3","2","9","2","9","11",79,0.00794686936219182,9941.02160227422,"27"
"371830515012009","4","3","4","11","4","3","5","12","5","16","17",16,0.00489323661824211,3269.81939527543,"5"
"371830511012008","5","4","5","14","5","5","5","15","5","19","20",20,0.00344636676436085,5803.21288111921,"14"
"371830528064024","4","2","1","7","4","3","2","9","3","10","12",67,0.127261161772987,526.476413279309,"19"
"371830528064006","2","1","1","4","2","2","2","6","3","7","9",571,0.067041587437269,8517.10142654791,"197"
"371830540181027","3","3","4","10","3","4","4","11","2","12","13",0,0.0196699616010038,0,"0"
"371830545003029","2","2","3","7","2","2","3","7","3","10","10",0,0.0170298954777479,0,"0"
"371830537093059","1","5","1","7","1","5","1","7","2","9","9",14,0.0060834436995955,2301.32811140027,"6"
"371830536102031","4","5","2","11","4","5","2","11","1","12","12",352,0.0449540437734206,7830.21882912616,"183"
"371830537073007","4","4","3","11","4","4","4","12","5","16","17",23,0.00268249989203548,8574.09167779971,"15"
"371830537093058","1","5","1","7","1","5","1","7","2","9","9",107,0.0243816037661452,4388.5546261142,"49"
"371830537093046","1","5","1","7","1","5","1","7","2","9","9",0,0.00196035442253422,0,"0"
"371830537142024","3","3","3","9","3","3","3","9","4","13","13",0,0.00609636911038391,0,"0"
"371830537092011","1","5","2","8","1","5","2","8","3","11","11",87,0.00489949518506684,17756.9314212548,"57"
"371830537142026","3","3","3","9","3","3","3","9","4","13","13",386,0.0313963407000876,12294.4264010654,"186"
"371830525052021","5","4","4","13","5","4","5","14","5","18","19",0,0.00225539839500424,0,"0"
"371830545002088","3","5","4","12","3","5","4","12","4","16","16",326,0.200878887395711,1622.86840706068,"153"
"371830545003003","2","2","3","7","2","2","3","7","3","10","10",27,0.0458921517338498,588.335891430537,"12"
"371830530081026","3","5","3","11","3","5","3","11","3","14","14",0,0.00333132239023695,0,"0"
"371830540143029","2","2","2","6","2","3","2","7","3","9","10",283,0.0845168059131305,3348.44646508385,"88"
"371830517003027","4","4","4","12","4","4","5","13","5","17","18",31,0.0119868452668351,2586.16836289445,"12"
"371830511023006","5","5","5","15","5","5","5","15","5","20","20",0,0.0622840693246363,0,"0"
"371830540061006","2","3","3","8","2","3","4","9","3","11","12",27,0.0141761614311276,1904.60585054529,"13"
"371830545001022","4","5","5","14","4","5","5","14","4","18","18",187,0.0643538855274344,2905.80744996789,"71"
"371830537093049","2","5","1","8","2","5","1","8","2","10","10",32,0.0135188800453147,2367.05998520124,"12"
"371830537143003","2","2","3","7","2","2","3","7","3","10","10",180,0.0304057188689274,5919.93896858489,"76"
"371830537224006","5","2","3","10","5","2","3","10","4","14","14",24,0.00858183430391841,2796.60491569288,"7"
"371830542071061","1","4","1","6","1","4","1","6","2","8","8",105,0.0783255532556698,1340.55867639083,"29"
"371830541103006","1","1","1","3","4","1","1","6","2","5","8",56,0.0168819232874013,3317.15759197838,"21"
"371830512003003","5","5","5","15","5","5","5","15","4","19","19",20,0.0149772768900975,1335.35622975786,"9"
"371830520023003","5","4","4","13","5","5","5","15","5","18","20",58,0.0107635124769684,5388.57553462289,"18"
"371830525051025","4","4","4","12","4","4","5","13","5","17","18",144,0.031827580372595,4524.3778607811,"44"
"371830537152006","3","4","3","10","3","4","3","10","4","14","14",318,0.0819064330416555,3882.47892370399,"112"
"371830540061001","2","1","2","5","2","1","3","6","4","9","10",180,0.0663311048586034,2713.65900483193,"80"
"371830527061016","3","3","4","10","3","4","4","11","3","13","14",0,0.0160119435020418,0,"0"
"371830516003001","3","4","5","12","4","4","5","13","3","15","16",48,0.0181419949232611,2645.79502987602,"22"
"371830527061014","3","3","4","10","3","3","4","10","3","13","13",0,0.0224941906592226,0,"0"
"371830527051016","4","2","4","10","4","3","5","12","3","13","15",132,0.041960191379002,3145.8388453885,"42"
"371830527051017","3","3","4","10","3","4","5","12","3","13","15",8,0.0167769435341828,476.844902273176,"4"
"371830527051007","4","3","4","11","4","3","4","11","3","14","14",63,0.0134957449556685,4668.13800993908,"23"
"371830527061027","3","3","3","9","3","3","4","10","3","12","13",0,0.00727059200086753,0,"0"
"371830506002032","5","4","5","14","5","5","5","15","4","18","19",24,0.00329205357252728,7290.28233327789,"11"
"371830506003025","5","5","5","15","5","5","5","15","5","20","20",11,0.00215890016848051,5095.18696630704,"6"
"371830528033070","1","1","2","4","1","2","2","5","3","7","8",6,0.00748565800742237,801.532743554505,"1"
"371830537192003","1","1","1","3","2","1","1","4","1","4","5",266,0.0354884029745987,7495.40632161986,"98"
"371830537252007","4","5","2","11","4","5","2","11","3","14","14",0,0.139753796968851,0,"0"
"371830541061013","1","1","1","3","1","1","2","4","2","5","6",0,0.00440004951873828,0,"0"
"371830542102032","1","1","1","3","1","1","1","3","2","5","5",83,0.364195604551015,227.899510490588,"37"
"371830528061012","5","2","2","9","5","4","2","11","3","12","14",89,0.10989070016624,809.895649635163,"27"
"371830541131006","1","1","1","3","1","2","1","4","2","5","6",7,0.0159553155029771,438.725263608473,"4"
"371830524062009","1","5","2","8","2","5","3","10","3","11","13",5,0.00369061837627547,1354.78651278108,"2"
"371830514004007","5","5","5","15","5","5","5","15","5","20","20",0,0.00642327119112424,0,"0"
"371830505003007","3","4","5","12","4","4","5","13","3","15","16",0,0.0207333606642459,0,"0"
"371830505001000","5","4","5","14","5","5","5","15","3","17","18",38,0.0105278878998624,3609.46092525326,"19"
"371830505001026","5","4","5","14","5","5","5","15","4","18","19",16,0.132034187181107,121.180736153231,"9"
"371830540131046","3","5","3","11","3","5","3","11","5","16","16",158,0.0658883796078346,2397.99492627396,"72"
"371830528021003","1","5","3","9","1","5","3","9","3","12","12",0,0.00699132262349672,0,"0"
"371830537251028","3","5","2","10","3","5","2","10","4","14","14",196,0.0233903457135011,8379.52557011021,"96"
"371830537111001","5","5","2","12","5","5","2","12","3","15","15",7,0.00577419447788523,1212.29030764542,"2"
"371830516001019","3","4","5","12","4","4","5","13","3","15","16",0,0.000811789427183359,0,"0"
"371830524011035","1","5","2","8","1","5","2","8","3","11","11",0,0.063873187765057,0,"0"
"371830525032018","3","5","3","11","3","5","3","11","3","14","14",75,0.0647407212879598,1158.46716730893,"34"
"371830525043003","4","3","4","11","4","3","4","11","5","16","16",73,0.0251279487841013,2905.13167736905,"53"
"371830528072010","3","1","2","6","3","3","2","8","3","9","11",46,0.00570831489432403,8058.42019082363,"16"
"371830541043000","1","2","2","5","3","2","2","7","2","7","9",203,0.024840549790155,8172.1218618299,"65"
"371830541043048","1","2","2","5","5","3","3","11","2","7","13",19,0.0300693673492138,631.872289807148,"5"
"371830523013032","2","5","3","10","3","5","3","11","3","13","14",89,0.00488459856668327,18220.5351749985,"24"
"371830545002093","3","5","4","12","3","5","5","13","5","17","18",0,0.00500600445034789,0,"0"
"371830505001008","5","4","5","14","5","5","5","15","3","17","18",31,0.00728593404882568,4254.77362164656,"17"
"371830505003018","5","5","5","15","5","5","5","15","4","19","19",18,0.00562018906147262,3202.73923227835,"11"
"371830540072004","2","2","3","7","3","2","3","8","4","11","12",14,0.00962476172977764,1454.58146321545,"5"
"371830525033034","2","5","3","10","2","5","4","11","4","14","15",0,0.0136437771915233,0,"0"
"371830506003021","5","5","5","15","5","5","5","15","5","20","20",7,0.0025059398733009,2793.36311081534,"5"
"371830506002014","5","4","5","14","5","5","5","15","3","17","18",46,0.0034127435729778,13478.8914011089,"18"
"371830507003025","5","5","5","15","5","5","5","15","4","19","19",14,0.00240205110645331,5828.35226210959,"8"
"371830507003017","5","4","5","14","5","4","5","14","4","18","18",20,0.0061554547081597,3249.15070425064,"8"
"371830508001003","5","5","5","15","5","5","5","15","5","20","20",164,0.0112804019611749,14538.4890152371,"59"
"371830508002000","5","5","5","15","5","5","5","15","5","20","20",72,0.0171376560042132,4201.27466570103,"21"
"371830524011063","1","5","2","8","1","5","3","9","4","12","13",23,0.337870753519904,68.0733675832793,"11"
"371830540131018","2","5","2","9","2","5","2","9","3","12","12",17,0.00691694802436535,2457.731349161,"6"
"371830527061035","2","2","4","8","2","2","5","9","4","12","13",0,0.00442662761175677,0,"0"
"371830525032002","3","5","2","10","3","5","3","11","3","13","14",1337,0.490476427434328,2725.92101315412,"626"
"371830517002017","4","4","5","13","4","4","5","13","3","16","16",70,0.0164481755664266,4255.79114943797,"33"
"371830519001002","2","3","4","9","4","3","5","12","4","13","16",42,0.0436353847681599,962.521591665827,"17"
"371830521021013","3","4","5","12","3","4","5","12","5","17","17",0,0.16116968613041,0,"0"
"371830527041014","4","3","4","11","4","3","4","11","3","14","14",0,0.0317630415342219,0,"0"
"371830504001011","3","3","5","11","3","4","5","12","3","14","15",2,0.0706192975921477,28.3208707561881,"1"
"371830506001000","4","4","5","13","4","5","5","14","3","16","17",69,0.0412330680221135,1673.4141627054,"22"
"371830505001028","5","4","5","14","5","5","5","15","3","17","18",36,0.00825118630528798,4363.00898659002,"19"
"371830524041003","5","5","4","14","5","5","4","14","4","18","18",75,0.0225016916606268,3333.08273578533,"32"
"371830524041028","4","5","4","13","4","5","4","13","5","18","18",4,0.00501895595893909,796.978501649479,"2"
"371830524082004","4","5","4","13","4","5","4","13","4","17","17",0,0.000924095850532914,0,"0"
"371830516005011","4","4","5","13","5","5","5","15","3","16","18",62,0.0206878472456816,2996.92854764974,"21"
"371830516005018","4","4","5","13","5","4","5","14","3","16","17",46,0.021182571920256,2171.59654517742,"22"
"371830540134008","1","3","1","5","1","4","1","6","5","10","11",56,0.00957011292259502,5851.55059850799,"14"
"371830540182003","2","2","3","7","2","2","3","7","2","9","9",106,0.00478427190112385,22155.9313915875,"52"
"371830527063002","2","3","3","8","3","4","4","11","3","11","14",193,0.0568286509589832,3396.1742315386,"74"
"371830542071054","1","2","1","4","1","2","1","4","2","6","6",0,0.00394031729125803,0,"0"
"371830537093030","1","5","1","7","1","5","1","7","2","9","9",79,0.0848608028082996,930.936279008118,"37"
"371830540131034","2","5","2","9","2","5","2","9","4","13","13",53,0.0256267797859555,2068.14903950773,"18"
"371830515011034","5","5","4","14","5","5","5","15","5","19","20",0,0.00692984532310339,0,"0"
"371830537231011","3","1","2","6","3","1","3","7","3","9","10",292,0.11383276818424,2565.16646882728,"128"
"371830540131000","2","5","2","9","2","5","2","9","3","12","12",580,0.14446958224032,4014.68593599994,"165"
"371830540162005","2","4","3","9","2","5","3","10","4","13","14",37,0.00200468485722898,18456.7663423886,"11"
"371830540131033","2","5","2","9","2","5","2","9","4","13","13",79,0.0323339464301956,2443.25264070533,"25"
"371830518002012","4","4","5","13","4","4","5","13","4","17","17",101,0.0154145154699182,6552.26563540733,"36"
"371830518002008","5","4","5","14","5","4","5","14","4","18","18",113,0.0204232276765187,5532.91584414544,"89"
"371830518001020","4","4","5","13","4","4","5","13","3","16","16",47,0.0140327961312272,3349.29685862184,"29"
"371830521014028","5","5","5","15","5","5","5","15","4","19","19",26,0.0239048536763749,1087.64522686436,"15"
"371830524011026","1","5","2","8","1","5","3","9","5","13","14",1264,0.273623785109303,4619.48145149397,"664"
"371830525032014","3","5","3","11","3","5","4","12","5","16","17",190,0.00276104863802797,68814.4342635355,"111"
"371830525033031","3","5","3","11","3","5","4","12","4","15","16",0,0.00647704815645878,0,"0"
"371830525051002","2","2","3","7","2","3","4","9","5","12","14",69,0.0190999633186807,3612.5723829278,"25"
"371830526021008","4","3","4","11","4","3","4","11","3","14","14",26,0.00670625492239836,3876.97758299674,"10"
"371830537092027","2","5","2","9","2","5","2","9","3","12","12",699,0.0185472213860999,37687.585943405,"362"
"371830537072007","4","3","3","10","4","3","4","11","4","14","15",30,0.00211885792171249,14158.5708473334,"13"
"371830525051013","2","3","3","8","2","3","4","9","5","13","14",179,0.0143041759779556,12513.8281489168,"101"
"371830525033019","2","5","2","9","2","5","2","9","3","12","12",68,0.0191947650299406,3542.63258205722,"23"
"371830524011045","1","5","2","8","1","5","3","9","4","12","13",38,0.00224602862670571,16918.7514122361,"28"
"371830525032023","3","5","3","11","3","5","4","12","5","16","17",195,0.00997472769129489,19549.4058619946,"129"
"371830525043002","5","3","4","12","5","3","4","12","5","17","17",377,0.038332750268023,9834.93220194252,"230"
"371830524011052","1","5","2","8","1","5","3","9","5","13","14",0,0.0129051352187093,0,"0"
"371830540131041","3","5","3","11","3","5","3","11","5","16","16",361,0.13255143169534,2723.47114914408,"225"
"371830537241068","1","5","2","8","1","5","2","8","3","11","11",43,0.00303224414893989,14180.916142598,"21"
"371830537241071","2","5","2","9","2","5","2","9","3","12","12",95,0.0174307292437013,5450.14489478855,"36"
"371830524011004","2","5","2","9","2","5","2","9","3","12","12",96,0.211853290258358,453.143776445136,"37"
"371830535171019","1","2","1","4","1","2","1","4","2","6","6",0,0.0174830678785267,0,"0"
"371830536101035","1","1","1","3","1","1","1","3","1","4","4",0,0.000489750528674813,0,"0"
"371830536101040","2","1","1","4","2","1","1","4","1","5","5",58,0.0139691721538146,4151.99980080149,"15"
"371830536101051","2","5","1","8","2","5","1","8","1","9","9",0,0.000393688525025981,0,"0"
"371830525033022","2","5","2","9","2","5","2","9","4","13","13",15,0.0203789305424718,736.054326734096,"6"
"371830524092001","4","5","5","14","4","5","5","14","4","18","18",132,0.00471921396720392,27970.7597318815,"88"
"371830524011007","2","5","3","10","2","5","3","10","5","15","15",2,0.620956357704819,3.22083826855789,"1"
"371830525043033","4","5","4","13","4","5","4","13","4","17","17",93,0.0112339160362185,8278.50232280221,"40"
"371830517002015","4","3","4","11","4","4","5","13","3","14","16",186,0.0432098357817347,4304.57548923674,"74"
"371830542071046","1","2","1","4","1","2","1","4","2","6","6",35,0.00578779576547194,6047.2071611093,"12"
"371830536102023","4","5","1","10","4","5","2","11","1","11","12",0,0.00126474238945469,0,"0"
"371830521021002","4","3","4","11","4","4","4","12","5","16","17",404,0.0829882411525921,4868.15956560831,"122"
"371830518001038","3","4","5","12","4","4","5","13","4","16","17",0,0.0186148473252808,0,"0"
"371830527061037","2","2","4","8","2","3","5","10","5","13","15",0,0.0137082823388545,0,"0"
"371830530081060","2","4","2","8","2","4","2","8","3","11","11",0,0.000713784379574798,0,"0"
"371830507003040","5","5","5","15","5","5","5","15","5","20","20",0,0.0251130914991333,0,"0"
"371830504001013","3","4","5","12","4","4","5","13","4","16","17",0,0.00419076040201194,0,"0"
"371830519003011","4","3","4","11","4","3","5","12","5","16","17",32,0.0313288984162063,1021.42116760309,"13"
"371830527072025","3","3","3","9","3","3","4","10","3","12","13",105,0.0258835327608178,4056.63326448807,"34"
"371830511021012","5","5","5","15","5","5","5","15","4","19","19",89,0.0192900845162675,4613.76931370858,"0"
"371830542091064","2","1","1","4","2","1","1","4","3","7","7",45,0.00371436711235953,12115.1191141723,"16"
"371830524062011","1","5","2","8","2","5","3","10","3","11","13",50,0.00382555764930628,13069.9899422681,"24"
"371830508001009","5","5","5","15","5","5","5","15","5","20","20",26,0.00134746296448167,19295.521053524,"25"
"371830530081012","3","4","2","9","3","4","3","10","3","12","13",0,0.00589766541324698,0,"0"
"371830504002000","5","4","5","14","5","4","5","14","3","17","17",39,0.0161158424433464,2419.97898261295,"28"
"371830523021002","5","5","4","14","5","5","5","15","5","19","20",0,0.00830669396024283,0,"0"
"371830514004006","5","5","5","15","5","5","5","15","5","20","20",0,0.000672858403564908,0,"0"
"371830512002021","4","5","5","14","4","5","5","14","4","18","18",17,0.0160195534562027,1061.20311321273,"7"
"371830504002002","5","4","5","14","5","4","5","14","3","17","17",75,0.00473408209302116,15842.5643084142,"26"
"371830530031011","2","3","2","7","2","4","2","8","3","10","11",0,0.00201669300803975,0,"0"
"371830507001016","5","5","5","15","5","5","5","15","5","20","20",57,0.0105012843565864,5427.90748869203,"27"
"371830540062003","3","3","4","10","3","3","4","10","4","14","14",316,0.108779374492581,2904.96246622149,"121"
"371830540011000","4","4","4","12","4","4","4","12","3","15","15",370,0.0659991058999114,5606.13655223013,"168"
"371830541131001","1","1","1","3","2","1","1","4","2","5","6",608,0.332786978368067,1826.99456265246,"218"
"371830527062018","3","2","4","9","3","2","5","10","4","13","14",0,0.160449371391872,0,"0"
"371830519003016","4","4","4","12","5","4","5","14","5","17","19",54,0.0110556633281121,4884.37449634431,"23"
"371830540012013","2","2","3","7","2","2","4","8","2","9","10",36,0.015720647265303,2289.98204669699,"17"
"371830524093010","4","5","4","13","4","5","5","14","4","17","18",23,0.00485770472124868,4734.74641210547,"9"
"371830521012001","4","4","5","13","4","5","5","14","4","17","18",58,0.0483634453273405,1199.25285734786,"31"
"371830541042014","5","5","3","13","5","5","3","13","4","17","17",167,0.0115375394735236,14474.4900230445,"39"
"371830525071012","2","2","2","6","2","2","2","6","5","11","11",34,0.0175176100616094,1940.90403202389,"21"
"371830505001024","5","4","5","14","5","5","5","15","3","17","18",33,0.00546625797303896,6037.0367009323,"18"
"371830505002011","5","5","5","15","5","5","5","15","4","19","19",17,0.00612290208097108,2776.46119032886,"12"
"371830537252015","2","5","2","9","2","5","2","9","3","12","12",18,0.0130179773278521,1382.7032838265,"6"
"371830541051033","4","4","2","10","4","4","3","11","4","14","15",0,0.00890318194103292,0,"0"
"371830541061009","2","1","1","4","2","2","2","6","3","7","9",90,0.0100584295273715,8947.71890135409,"26"
"371830541054001","2","3","2","7","3","3","3","9","3","10","12",9,0.00562834859375227,1599.04807779504,"9"
"371830527063033","2","3","4","9","3","3","5","11","5","14","16",0,0.129869574353307,0,"0"
"371830520012003","2","3","4","9","5","4","5","14","4","13","18",17,0.0217472112790849,781.709423881376,"8"
"371830521021039","2","2","4","8","2","3","4","9","3","11","12",18,0.0415156070113741,433.571885268798,"4"
"371830537142021","2","2","3","7","2","2","3","7","3","10","10",0,0.000805705110374686,0,"0"
"371830520012021","3","4","4","11","4","5","5","14","4","15","18",102,0.00725731304988237,14054.7885007735,"22"
"371830537093024","1","5","1","7","1","5","1","7","3","10","10",58,0.0302394658285408,1918.02329872038,"27"
"371830537093027","1","5","1","7","1","5","1","7","2","9","9",21,0.0484010496369542,433.87488820008,"10"
"371830537073010","4","3","3","10","4","3","4","11","5","15","16",33,0.00404681438606165,8154.56229316105,"18"
"371830525072012","2","5","2","9","2","5","2","9","3","12","12",233,0.00258994481722884,89963.3067276325,"56"
"371830526032004","3","3","4","10","3","3","5","11","4","14","15",0,0.0218314815348776,0,"0"
"371830541131000","1","1","1","3","1","1","1","3","2","5","5",144,0.367102140833409,392.261400800023,"63"
"371830541061044","2","2","2","6","2","2","2","6","3","9","9",65,0.0219897982609498,2955.91615842285,"22"
"371830528072067","4","2","1","7","4","4","2","10","2","9","12",53,0.00984909828890981,5381.20327824107,"15"
"371830537222017","2","2","3","7","2","2","3","7","3","10","10",17,0.00560720908371827,3031.81132470397,"9"
"371830537181006","1","1","1","3","4","1","1","6","1","4","7",111,0.0110754842103764,10022.135185386,"27"
"371830526021021","3","2","4","9","3","2","4","9","2","11","11",36,0.0104460553339454,3446.27697720637,"18"
"371830545002084","3","4","4","11","3","4","5","12","4","15","16",0,0.0146386435807843,0,"0"
"371830528061020","1","2","3","6","4","3","4","11","3","9","14",124,0.479305110223706,258.707861349789,"48"
"371830545002004","3","5","5","13","3","5","5","13","4","17","17",0,0.00804325042297317,0,"0"
"371830526031004","4","3","4","11","4","3","4","11","5","16","16",29,0.00988285313487461,2934.37528659257,"10"
"371830527062007","3","2","4","9","3","2","4","9","3","12","12",0,0.0783222948403429,0,"0"
"371830537111013","4","1","1","6","4","1","2","7","2","8","9",215,0.0521723267034651,4120.95863046339,"66"
"371830545003027","2","4","3","9","2","4","3","9","3","12","12",22,0.00870950572730518,2525.97571995708,"9"
"371830537171036","1","5","1","7","3","5","2","10","1","8","11",7,0.153269418585779,45.6712112865645,"4"
"371830545004015","3","5","4","12","3","5","4","12","4","16","16",19,0.00807284833834992,2353.56830745114,"9"
"371830537241033","2","5","2","9","2","5","2","9","2","11","11",538,0.0525435796726612,10239.1196669824,"272"
"371830536101057","2","5","1","8","2","5","1","8","1","9","9",28,0.00766305470332373,3653.89535688104,"11"
"371830528072002","3","2","2","7","3","3","3","9","3","10","12",92,0.132120197335742,696.335623585322,"35"
"371830541063022","5","4","3","12","5","4","3","12","5","17","17",12,0.00533939526527878,2247.44552590704,"11"
"371830528062001","3","2","2","7","3","3","3","9","3","10","12",153,0.0316608448399874,4832.46738276429,"70"
"371830530081033","2","4","2","8","2","4","2","8","3","11","11",0,0.00178381597804349,0,"0"
"371830537122010","2","2","2","6","2","2","2","6","3","9","9",0,0.0290180185278747,0,"0"
"371830536102051","3","1","1","5","3","1","1","5","1","6","6",0,0.0216205860497769,0,"0"
"371830537072020","5","5","4","14","5","5","4","14","5","19","19",163,0.026228082695885,6214.71275235736,"65"
"371830536101074","2","5","1","8","2","5","1","8","1","9","9",42,0.00200455175329169,20952.3151153526,"22"
"371830537122006","2","1","2","5","2","1","2","5","3","8","8",156,0.0940261802268462,1659.11238363227,"58"
"371830537171013","1","1","1","3","1","1","1","3","1","4","4",0,0.0100759692884634,0,"0"
"371830537262006","1","5","2","8","1","5","2","8","3","11","11",0,0.0956228719033353,0,"0"
"371830537251010","4","5","2","11","4","5","2","11","4","15","15",54,0.0164663021622734,3279.4248197219,"18"
"371830527012034","2","3","4","9","2","3","4","9","3","12","12",211,0.094941272006006,2222.42651211427,"83"
"371830504001007","4","4","5","13","4","4","5","13","3","16","16",0,0.0100287603503892,0,"0"
"371830537142010","3","5","3","11","3","5","3","11","5","16","16",101,0.10725248086084,941.703158652783,"42"
"371830537241062","3","5","2","10","3","5","2","10","3","13","13",27,0.0047860689389945,5641.37298149166,"17"
"371830525062002","4","2","2","8","4","2","3","9","3","11","12",10,0.0147545034177563,677.759170665516,"4"
"371830537224001","4","2","3","9","4","2","3","9","4","13","13",0,0.00861910273769041,0,"0"
"371830537071023","4","2","3","9","4","2","3","9","3","12","12",88,0.0523012343343909,1682.56067222749,"38"
"371830537151009","4","4","4","12","4","4","4","12","5","17","17",111,0.0368320709702713,3013.67794630915,"46"
"371830545002058","1","2","3","6","1","2","3","6","2","8","8",18,0.00771643725942543,2332.6827387877,"6"
"371830545002006","2","3","4","9","2","3","4","9","3","12","12",175,0.197335559053489,886.81432195687,"78"
"371830521011004","4","4","4","12","4","4","5","13","3","15","16",40,0.00598041138264304,6688.50308794677,"15"
"371830537091000","2","5","2","9","2","5","2","9","3","12","12",230,0.0526325216139429,4369.92173179616,"142"
"371830537224003","3","2","2","7","3","2","3","8","3","10","11",182,0.0599478885603513,3035.97014625086,"60"
"371830528064048","1","1","1","3","1","2","1","4","4","7","8",56,0.00360276201624926,15543.6300669951,"18"
"371830541062045","4","3","2","9","4","4","3","11","5","14","16",144,0.0961515877117769,1497.63517615178,"47"
"371830523022002","4","5","4","13","5","5","4","14","3","16","17",124,0.0232060607327505,5343.43167623447,"42"
"371830545004019","2","4","3","9","2","4","4","10","3","12","13",43,0.0174967477757825,2457.59958084992,"18"
"371830537092028","2","5","2","9","2","5","2","9","3","12","12",1,0.00243560066617891,410.576337035105,"1"
"371830530081003","1","2","2","5","4","2","3","9","2","7","11",333,0.0333658901357839,9980.25224697564,"150"
"371830519002003","4","5","5","14","4","5","5","14","4","18","18",167,0.0177558950697483,9405.3270389352,"65"
"371830520021007","4","4","4","12","4","5","5","14","5","17","19",44,0.0065829116660089,6683.97241712897,"14"
"371830525071016","3","3","3","9","3","3","3","9","4","13","13",2,0.00516625927491081,387.127299187772,"1"
"371830503001018","5","5","5","15","5","5","5","15","3","18","18",165,0.0299918511103364,5501.49436901994,"96"
"371830505001001","5","4","5","14","5","5","5","15","3","17","18",19,0.00637795378271322,2979.01186607804,"12"
"371830505002008","4","5","5","14","4","5","5","14","4","18","18",57,0.0131558421139104,4332.67589459216,"31"
"371830505003012","5","5","5","15","5","5","5","15","4","19","19",34,0.0100813393324379,3372.56775898822,"18"
"371830527052036","2","2","4","8","2","3","5","10","5","13","15",0,0.00324656082478248,0,"0"
"371830545004007","5","5","4","14","5","5","4","14","4","18","18",65,0.0299987701039342,2166.75549613534,"21"
"371830527061032","3","2","4","9","3","2","4","9","3","12","12",0,0.0917741491791337,0,"0"
"371830537091005","2","5","2","9","2","5","2","9","3","12","12",0,0.00340413778354553,0,"0"
"371830537142032","3","3","3","9","3","3","3","9","4","13","13",0,0.000833256168765521,0,"0"
"371830527061031","3","2","4","9","3","2","5","10","4","13","14",0,0.0318766949465504,0,"0"
"371830545002060","1","2","3","6","1","2","3","6","2","8","8",0,0.0253492289215485,0,"0"
"371830528064025","4","2","2","8","4","5","2","11","3","11","14",19,0.0705813839536258,269.192794696171,"8"
"371830528033057","1","1","2","4","1","1","2","4","2","6","6",0,0.0224940597269817,0,"0"
"371830525041007","2","5","3","10","2","5","4","11","4","14","15",108,0.320789998525526,336.668850327035,"41"
"371830524071013","2","5","4","11","3","5","4","12","3","14","15",79,0.0044742936128216,17656.4183838129,"24"
"371830505003000","4","5","5","14","4","5","5","14","5","19","19",0,0.0976939650379079,0,"0"
"371830530081014","2","4","3","9","2","4","3","9","3","12","12",0,0.0424232656078256,0,"0"
"371830515011013","4","3","4","11","4","3","5","12","4","15","16",13,0.00740780003002899,1754.90698281567,"7"
"371830520023000","3","4","4","11","4","5","5","14","5","16","19",454,0.133281472765889,3406.32490456838,"151"
"371839802001020","1","1","1","3","1","1","1","3","1","4","4",0,0.36810317030891,0,"0"
"371830537092005","1","5","2","8","1","5","2","8","3","11","11",0,0.00105448838343349,0,"0"
"371830540072007","2","1","2","5","2","1","3","6","4","9","10",334,0.0746446458183549,4474.53392454667,"131"
"371830537232012","5","2","3","10","5","2","3","10","4","14","14",35,0.0107194171914632,3265.10288524582,"23"
"371830537231001","3","2","3","8","3","2","3","8","3","11","11",82,0.0111993570331664,7321.84890232188,"32"
"371830537143014","3","3","3","9","3","3","3","9","3","12","12",34,0.00363571537112285,9351.66714920796,"25"
"371830525042003","5","5","4","14","5","5","5","15","5","19","20",14,0.00236489816443715,5919.91664187875,"10"
"371830524011019","1","5","2","8","1","5","2","8","3","11","11",0,0.0151994495453233,0,"0"
"371830537241076","2","5","2","9","2","5","2","9","2","11","11",170,0.0152227334212692,11167.5081797383,"50"
"371830537122007","2","2","2","6","2","2","2","6","3","9","9",0,0.0366747599252559,0,"0"
"371830537112022","5","3","3","11","5","3","3","11","5","16","16",0,0.0134968876100613,0,"0"
"371830524011090","1","5","2","8","2","5","2","9","3","11","12",0,0.000432092353250592,0,"0"
"371830540133001","1","4","1","6","1","5","2","8","3","9","11",2,0.00269306803647367,742.647409167879,"1"
"371830540142005","5","3","2","10","5","4","2","11","4","14","15",189,0.0237953738243461,7942.7203537616,"57"
"371830540162028","3","4","2","9","3","5","3","11","5","14","16",240,0.0345256160378877,6951.36039677406,"82"
"371830537132008","4","2","2","8","4","2","3","9","4","12","13",86,0.00918150396855087,9366.65717235142,"68"
"371830536101058","2","5","1","8","2","5","1","8","1","9","9",406,0.168410331527336,2410.77846185523,"192"
"371830527011015","4","3","4","11","4","3","4","11","2","13","13",21,0.00580045711194079,3620.40432240581,"8"
"371830537091008","1","1","1","3","1","1","1","3","3","6","6",331,0.199554485286496,1658.69486483749,"187"
"371830525052022","4","4","4","12","4","4","5","13","5","17","18",0,0.000474146596197116,0,"0"
"371830537141008","3","2","3","8","3","2","3","8","4","12","12",53,0.0123346241875546,4296.84757266264,"22"
"371839802001016","1","5","1","7","1","5","1","7","3","10","10",0,0.0135040525267432,0,"0"
"371830537141014","3","2","3","8","3","2","3","8","4","12","12",65,0.015667253219885,4148.78084165394,"29"
"371830521021016","3","3","4","10","3","3","4","10","5","15","15",31,0.0115615257204841,2681.30701340531,"9"
"371830537142015","5","2","3","10","5","2","3","10","5","15","15",99,0.0335491536421709,2950.89411363147,"40"
"371830537152002","4","3","3","10","4","3","3","10","5","15","15",19,0.00641937654598148,2959.78898634541,"7"
"371830537181014","1","1","1","3","2","1","1","4","1","4","5",86,0.0169442792355366,5075.45932196605,"38"
"371830537241072","2","5","2","9","2","5","2","9","2","11","11",79,0.00919755899952514,8589.23547041978,"22"
"371830537111014","3","1","2","6","3","1","2","6","3","9","9",141,0.0262402880572883,5373.41662150073,"49"
"371830527012010","3","3","4","10","3","3","4","10","2","12","12",0,0.0308343957961853,0,"0"
"371830540132014","1","4","1","6","1","5","2","8","5","11","13",80,0.0162922717588212,4910.30355890579,"27"
"371830524081004","4","5","4","13","4","5","5","14","4","17","18",48,0.00979609340318599,4899.91244717909,"21"
"371830524081015","4","5","4","13","4","5","5","14","4","17","18",57,0.027673959042768,2059.69806892866,"27"
"371830524041007","4","5","4","13","4","5","4","13","3","16","16",45,0.0231028489858693,1947.81171913144,"19"
"371830515012013","3","2","3","8","3","2","4","9","3","11","12",211,0.143580438256226,1469.55952052089,"85"
"371830517001011","5","4","5","14","5","5","5","15","5","19","20",0,0.0149196916124382,0,"0"
"371830524071007","3","5","4","12","4","5","4","13","3","15","16",36,0.0137021214125585,2627.33039038792,"17"
"371830530081013","2","4","2","8","2","4","2","8","3","11","11",0,0.000857477945363189,0,"0"
"371830515012002","3","3","4","10","3","3","5","11","3","13","14",38,0.0138041236619289,2752.80060731434,"14"
"371830515012038","3","3","4","10","3","3","5","11","4","14","15",41,0.00988567120489043,4147.4169179041,"13"
"371830524071021","2","5","4","11","3","5","4","12","3","14","15",0,0.0039463234526168,0,"0"
"371830511011004","4","5","5","14","4","5","5","14","5","19","19",1118,0.041886576312757,26691.1287199069,"0"
"371830504001012","3","4","5","12","4","5","5","14","3","15","17",0,0.00206795838662447,0,"0"
"371830524041017","5","5","4","14","5","5","4","14","4","18","18",53,0.0267738456731568,1979.54379236365,"17"
"371830518002009","5","4","5","14","5","4","5","14","4","18","18",80,0.0114002208586465,7017.40790743752,"29"
"371830509002027","4","5","5","14","4","5","5","14","5","19","19",0,0.056919992001377,0,"0"
"371830537091002","2","5","2","9","2","5","2","9","3","12","12",0,0.00444720265613942,0,"0"
"371830537261009","4","5","3","12","4","5","3","12","5","17","17",211,0.0323795413417573,6516.46043323938,"111"
"371830537073011","5","4","3","12","5","4","4","13","5","17","18",49,0.00366603757920043,13365.9295469325,"25"
"371830509001028","4","5","5","14","4","5","5","14","5","19","19",0,0.0023068598141212,0,"0"
"371830518003017","5","4","5","14","5","4","5","14","4","18","18",269,0.0523401766019124,5139.45533745431,"100"
"371830524062003","1","5","2","8","2","5","2","9","2","10","11",383,0.0639635403592547,5987.78613330125,"142"
"371830527062013","2","2","3","7","2","2","4","8","3","10","11",0,0.0121197029208804,0,"0"
"371830537231015","4","1","3","8","4","2","3","9","3","11","12",56,0.0190237404321785,2943.69029054226,"22"
"371830524072010","2","4","3","9","2","4","3","9","3","12","12",325,0.0623488925428613,5212.60261000757,"113"
"371830524041014","4","5","4","13","4","5","4","13","5","18","18",57,0.0256023789698169,2226.35560809401,"23"
"371830537231005","3","2","3","8","3","2","3","8","3","11","11",394,0.065179558573832,6044.83995628318,"226"
"371830509001009","5","5","5","15","5","5","5","15","5","20","20",220,0.0238031449640206,9242.4761657562,"100"
"371830511023001","5","5","5","15","5","5","5","15","5","20","20",0,0.000117481574446077,0,"0"
"371830526031009","3","3","4","10","3","3","5","11","4","14","15",1505,0.158778587194555,9478.60808306532,"656"
"371830524012002","3","5","4","12","3","5","5","13","5","17","18",0,0.00446256178324346,0,"0"
"371830541054019","5","5","4","14","5","5","4","14","2","16","16",6,0.000895390624967842,6700.98595260085,"1"
"371830541062032","3","2","3","8","4","3","5","12","3","11","15",140,0.0144328147375617,9700.11758244542,"97"
"371830537093017","1","5","1","7","1","5","1","7","2","9","9",0,0.000406699897980602,0,"0"
"371839802001018","1","5","1","7","1","5","1","7","2","9","9",0,0.393105630144753,0,"0"
"371830525061006","3","2","2","7","3","2","3","8","3","10","11",323,0.210996749287863,1530.82927149428,"121"
"371830520012002","1","3","4","8","4","4","5","13","4","12","17",123,0.0828940540954329,1483.82174502401,"55"
"371830527013017","4","3","4","11","4","4","5","13","5","16","18",0,0.0195740277413157,0,"0"
"371830528072001","2","1","2","5","2","2","3","7","4","9","11",0,0.0573062172231893,0,"0"
"371830519002011","4","4","5","13","4","4","5","13","4","17","17",52,0.0113994292324451,4561.63189749864,"29"
"371830545002063","1","1","2","4","1","1","2","4","2","6","6",0,0.234870644964969,0,"0"
"371830523023010","2","5","3","10","2","5","3","10","3","13","13",0,0.000457974872936926,0,"0"
"371830515022006","5","3","4","12","5","3","5","13","4","16","17",85,0.056720533814797,1498.57545906639,"35"
"371830524063004","1","5","2","8","3","5","2","10","2","10","12",15,0.0307011847452371,488.580493699908,"6"
"371830541061032","1","2","3","6","3","3","4","10","4","10","14",0,0.0809529228885544,0,"0"
"371830528033028","3","3","4","10","3","4","4","11","3","13","14",82,0.0646371576202999,1268.6201407818,"25"
"371830518001025","4","4","5","13","4","4","5","13","3","16","16",0,0.00779831347745368,0,"0"
"371830501001000","5","5","5","15","5","5","5","15","4","19","19",75,0.0074319984763599,10091.498301374,"33"
"371830526021010","3","3","4","10","3","3","4","10","3","13","13",134,0.0449749300706024,2979.4376509234,"61"
"371830521012011","4","4","5","13","4","4","5","13","3","16","16",142,0.0809093363244284,1755.05085631418,"51"
"371830525032022","4","5","3","12","4","5","4","13","4","16","17",2,0.021741578698426,91.9896401149929,"1"
"371830541044020","3","3","2","8","3","3","3","9","2","10","11",220,0.0227686076960598,9662.42657156729,"73"
"371830541054012","5","5","3","13","5","5","4","14","2","15","16",32,0.00457581275590723,6993.29314965719,"21"
"371830515011012","4","3","4","11","4","3","5","12","4","15","16",28,0.009555598900136,2930.21926648695,"14"
"371830515011026","4","3","4","11","4","3","5","12","4","15","16",92,0.026070548069318,3528.88630324858,"35"
"371830516002020","5","4","4","13","5","4","5","14","3","16","17",0,0.0103688888693452,0,"0"
"371830527073026","3","3","3","9","3","4","4","11","2","11","13",13,0.00579103228766121,2244.85020187139,"4"
"371830540131053","1","5","2","8","1","5","2","8","4","12","12",282,0.0471164375232272,5985.17236921788,"76"
"371830540121004","3","4","4","11","3","4","4","11","2","13","13",4,0.00280706689043391,1424.97494934354,"2"
"371830540112006","2","4","3","9","2","4","3","9","3","12","12",30,0.00922412843386608,3252.33979720577,"13"
"371830540162016","3","5","3","11","3","5","3","11","2","13","13",7,0.0498147908052227,140.520513824302,"3"
"371830537222016","2","2","3","7","2","2","3","7","3","10","10",53,0.00765983367092861,6919.21029579938,"41"
"371830526021005","4","3","4","11","4","3","4","11","3","14","14",221,0.0593636002894963,3722.82002645152,"86"
"371830511011003","4","5","5","14","4","5","5","14","5","19","19",0,0.0314261507449466,0,"0"
"371830507001013","5","5","5","15","5","5","5","15","5","20","20",131,0.0113462425640565,11545.672433885,"50"
"371830541051023","3","2","2","7","3","2","2","7","4","11","11",0,0.0923917669049255,0,"0"
"371830541063027","3","3","2","8","3","3","3","9","4","12","13",4,0.0404637696855523,98.8538643602505,"2"
"371830541054020","4","5","3","12","4","5","3","12","3","15","15",50,0.0145388360887271,3439.06483950033,"13"
"371830528063017","1","1","2","4","4","3","3","10","5","9","15",3,0.0929276664529497,32.2831737254366,"1"
"371830540121007","2","4","3","9","2","4","4","10","3","12","13",38,0.0432085303852506,879.455969948274,"17"
"371830523011016","3","5","3","11","3","5","3","11","4","15","15",47,0.00346878574055339,13549.4099420802,"20"
"371830503001009","5","5","5","15","5","5","5","15","3","18","18",72,0.00501326968207672,14361.8844718073,"53"
"371830536101020","1","5","1","7","1","5","1","7","1","8","8",31,0.00638262878059439,4856.93294497273,"11"
"371830540141007","1","2","1","4","2","3","2","7","3","7","10",7,0.000405288027934833,17271.6673514115,"5"
"371839802001015","1","5","1","7","1","5","1","7","3","10","10",0,0.932462842326351,0,"0"
"371830526012003","4","4","4","12","4","4","5","13","4","16","17",54,0.0105496374200551,5118.65932921495,"16"
"371830524011033","1","5","3","9","1","5","3","9","5","14","14",0,0.0744005255383376,0,"0"
"371830524011076","1","5","1","7","1","5","2","8","3","10","11",0,0.0079806125874702,0,"0"
"371830525032019","4","5","3","12","4","5","3","12","3","15","15",83,0.0391938766112228,2117.6777388801,"33"
"371830512001000","5","5","5","15","5","5","5","15","3","18","18",643,0.0747382982017224,8603.35350778942,"474"
"371830528033069","1","1","2","4","1","1","2","4","3","7","7",0,0.0140525441426138,0,"0"
"371830545002046","1","2","3","6","1","2","3","6","3","9","9",0,0.00314099258450323,0,"0"
"371830545002037","3","4","4","11","3","4","4","11","4","15","15",0,0.00691393511322624,0,"0"
"371830528072018","4","1","1","6","4","3","2","9","2","8","11",69,0.0085785105551058,8043.35432785966,"23"
"371830537092023","2","5","2","9","2","5","2","9","3","12","12",121,0.00564034087538374,21452.6041374703,"74"
"371830525032003","3","5","3","11","3","5","3","11","4","15","15",68,0.0688552108292485,987.57957721792,"27"
"371830525033020","2","5","2","9","2","5","2","9","3","12","12",137,0.0299379863582573,4576.12607476566,"48"
"371830524011057","1","5","3","9","1","5","4","10","4","13","14",0,0.0460027976978047,0,"0"
"371830525031012","2","5","2","9","2","5","2","9","3","12","12",223,0.0146048752357219,15268.8740164358,"154"
"371830545001048","2","5","3","10","2","5","4","11","3","13","14",0,0.0184374274895745,0,"0"
"371830527052030","2","2","4","8","2","3","5","10","5","13","15",0,0.00752828392814723,0,"0"
"371830524011041","1","5","2","8","1","5","3","9","4","12","13",673,0.0612730195354381,10983.6271347907,"382"
"371830540131006","3","5","2","10","3","5","2","10","4","14","14",5,0.0123534860367691,404.744052417101,"2"
"371830540081010","4","3","3","10","4","4","3","11","2","12","13",190,0.0330096881439483,5755.88594389168,"66"
"371830540131039","4","5","3","12","4","5","3","12","5","17","17",0,0.0018668667236384,0,"0"
"371830528072045","1","1","1","3","1","1","1","3","2","5","5",0,0.119239912043342,0,"0"
"371830537073003","5","3","3","11","5","3","4","12","5","16","17",281,0.0162318994468297,17311.5907303679,"130"
"371830540143014","2","3","2","7","2","4","3","9","2","9","11",0,0.178808574253563,0,"0"
"371830521014016","5","5","5","15","5","5","5","15","5","20","20",22,0.0110341610625636,1993.8081268943,"9"
"371830521021032","3","3","4","10","3","3","4","10","3","13","13",226,0.0219639195464646,10289.6024328398,"67"
"371830540084002","2","3","3","8","4","4","4","12","2","10","14",1367,0.076072664449604,17969.6611113917,"461"
"371830540084000","2","3","3","8","3","4","4","11","2","10","13",466,0.0588994895748493,7911.78333401019,"125"
"371830540062006","4","3","4","11","4","3","4","11","4","15","15",45,0.0103392772678269,4352.33516176496,"15"
"371830526022005","3","3","4","10","3","3","5","11","3","13","14",1539,0.216735453789592,7100.82256082601,"606"
"371830537072019","4","4","4","12","4","4","4","12","4","16","16",123,0.0195789719941938,6282.25016290314,"44"
"371830537091001","1","5","2","8","1","5","2","8","3","11","11",94,0.00401229499918412,23427.988225969,"60"
"371830540061008","2","2","3","7","2","2","3","7","3","10","10",1304,0.178182814736058,7318.32641622376,"384"
"371830540012014","2","2","3","7","2","2","4","8","2","9","10",59,0.016720082537951,3528.69071465902,"25"
"371830537093048","2","5","1","8","2","5","1","8","2","10","10",79,0.0984393571149119,802.524542168438,"35"
"371830523022003","3","5","4","12","5","5","4","14","3","15","17",43,0.00273074097501816,15746.6418065207,"26"
"371830523022004","4","5","4","13","4","5","4","13","3","16","16",78,0.0153837417403495,5070.28792581822,"27"
"371830545004001","4","5","4","13","4","5","4","13","3","16","16",41,0.00939492476134836,4364.05836571231,"13"
"371830501001040","4","5","5","14","4","5","5","14","5","19","19",0,0.0102493407010842,0,"0"
"371830545002015","3","3","4","10","3","3","5","11","3","13","14",0,0.0333543565407421,0,"0"
"371830541141033","1","1","1","3","1","1","1","3","2","5","5",0,0.00892863397779961,0,"0"
"371830541062049","4","2","2","8","4","2","2","8","5","13","13",0,0.000113877002872189,0,"0"
"371830541063006","2","2","2","6","2","3","2","7","3","9","10",180,0.0258739782681246,6956.79644369766,"59"
"371830545004009","2","4","3","9","2","4","4","10","3","12","13",53,0.0209505360136331,2529.76821048929,"22"
"371830545002080","3","5","5","13","3","5","5","13","5","18","18",0,0.00652350278244443,0,"0"
"371830545002083","3","4","4","11","3","4","5","12","4","15","16",97,0.0186693061914215,5195.69388414504,"27"
"371830517001007","4","4","5","13","4","4","5","13","4","17","17",105,0.022724095963082,4620.64586290188,"30"
"371830514005024","5","4","5","14","5","5","5","15","3","17","18",0,0.00176873878898467,0,"0"
"371830540151033","4","3","3","10","4","4","3","11","2","12","13",41,0.034970498495596,1172.41680169825,"15"
"371830504001017","3","3","4","10","4","4","5","13","3","13","16",91,0.0421573883296629,2158.57773940826,"59"
"371830512003029","5","5","5","15","5","5","5","15","4","19","19",32,0.00652817018756316,4901.83299157294,"12"
"371830518001001","3","3","4","10","3","3","5","11","5","15","16",0,0.00211158919073391,0,"0"
"371830516003010","4","4","5","13","4","4","5","13","3","16","16",88,0.0269839810777435,3261.19410425257,"43"
"371830518003005","3","4","4","11","5","4","5","14","4","15","18",153,0.0958658221174079,1595.98068029521,"83"
"371830507003039","5","4","5","14","5","4","5","14","4","18","18",68,0.012863568061771,5286.24714958271,"24"
"371830524062016","1","5","2","8","2","5","3","10","3","11","13",0,0.00226587333531146,0,"0"
"371830520012022","2","4","4","10","4","4","5","13","3","13","16",550,0.177943894398357,3090.86188014258,"202"
"371830516005002","3","4","5","12","5","4","5","14","3","15","17",90,0.0292152019121916,3080.58798534069,"35"
"371830530081005","1","2","2","5","3","2","2","7","2","7","9",0,0.0706961704403153,0,"0"
"371830524082009","4","5","4","13","4","5","4","13","4","17","17",217,0.0201999096982786,10742.6222810537,"82"
"371830524063018","1","2","2","5","3","2","2","7","2","7","9",73,0.00767343620652513,9513.33900944198,"42"
"371830523021042","4","5","4","13","4","5","5","14","5","18","19",0,0.00174465984011521,0,"0"
"371830528072055","1","1","1","3","1","1","1","3","2","5","5",22,0.0463075969485318,475.084034795667,"7"
"371830521011010","3","3","4","10","3","3","4","10","3","13","13",100,0.0107728834171748,9282.5658765205,"47"
"371830521014007","4","4","5","13","4","4","5","13","4","17","17",33,0.00693873372217028,4755.91099490677,"11"
"371830537252036","1","5","2","8","1","5","2","8","3","11","11",7,0.000390172276220302,17940.7928923366,"2"
"371830521021008","2","3","4","9","2","4","4","10","3","12","13",0,0.0649824063861971,0,"0"
"371830527011004","4","2","3","9","4","2","4","10","2","11","12",120,0.0439534840599717,2730.15899800497,"46"
"371830541103021","1","1","1","3","4","2","2","8","2","5","10",51,0.0289030354773102,1764.52054802467,"24"
"371830542091074","3","2","1","6","3","3","1","7","4","10","11",272,0.111383113465312,2442.02187869985,"98"
"371830537092003","1","5","2","8","1","5","2","8","3","11","11",0,0.0233874841035944,0,"0"
"371830528064001","1","1","1","3","1","2","1","4","4","7","8",178,0.108873717482667,1634.92166994609,"57"
"371830527012027","2","2","4","8","2","3","4","9","3","11","12",1,0.139102705446751,7.18893278738425,"1"
"371830538084022","4","4","3","11","4","4","3","11","4","15","15",0,0.013967086083006,0,"0"
"371830527062019","2","1","3","6","2","1","4","7","3","9","10",92,0.0557414954647187,1650.47599159285,"39"
"371830541051005","1","1","1","3","1","1","2","4","3","6","7",415,0.151029629367123,2747.80519384854,"155"
"371830527043022","4","2","3","9","4","3","4","11","2","11","13",26,0.00984250682928892,2641.60345031515,"17"
"371830528062017","4","4","4","12","4","5","4","13","3","15","16",81,0.0133694504608522,6058.58858875166,"18"
"371830541132038","5","3","2","10","5","4","2","11","5","15","16",67,0.00484914876266695,13816.858025851,"30"
"371839802001021","1","5","2","8","1","5","2","8","5","13","13",0,0.0418427402058247,0,"0"
"371830537223008","4","3","3","10","4","3","3","10","2","12","12",79,0.0140649464072326,5616.8006413004,"39"
"371830536102010","3","5","1","9","3","5","2","10","1","10","11",43,0.00213920383516978,20100.9362890317,"22"
"371830537221000","3","2","2","7","3","2","2","7","3","10","10",397,0.122055208694718,3252.6264486833,"144"
"371830537241002","1","5","1","7","1","5","1","7","2","9","9",67,0.0111129139566402,6029.02175445768,"20"
"371830538071001","2","1","2","5","2","2","3","7","3","8","10",2,0.0962857953106126,20.7714958738006,"1"
"371830537132009","4","2","3","9","4","2","3","9","4","13","13",0,0.00325358920622461,0,"0"
"371830537122017","5","3","3","11","5","3","3","11","5","16","16",10,0.00303721602389978,3292.48888498883,"4"
"371830537252025","1","5","2","8","1","5","2","8","3","11","11",45,0.00596616745218767,7542.53050398366,"25"
"371830537113013","3","5","3","11","3","5","3","11","4","15","15",48,0.0108299954247452,4432.13483639394,"35"
"371830537131013","3","5","3","11","3","5","3","11","5","16","16",7,0.0152810607583987,458.083382474132,"3"
"371830537262012","2","5","2","9","2","5","2","9","3","12","12",25,0.0651250949416917,383.876599679174,"13"
"371830537111011","1","5","1","7","1","5","1","7","2","9","9",52,0.0329345449440813,1578.88928140011,"16"
"371830520011012","2","2","3","7","5","3","5","13","3","10","16",7,0.0250412367497446,279.538908958696,"2"
"371830537092000","1","5","2","8","1","5","2","8","3","11","11",0,0.0161526051801125,0,"0"
"371830520011003","2","3","3","8","3","3","4","10","4","12","14",1477,0.0733047579487132,20148.7603442244,"420"
"371830524072012","3","5","3","11","3","5","4","12","4","15","16",214,0.0859900470472106,2488.66011065803,"93"
"371830524041018","5","5","4","14","5","5","4","14","5","19","19",701,0.311335004787774,2251.59390759111,"248"
"371830528033062","1","1","2","4","1","2","2","5","3","7","8",0,0.0172383984783629,0,"0"
"371830537092016","1","5","2","8","1","5","2","8","3","11","11",0,0.00266990057122518,0,"0"
"371830537092017","2","5","2","9","2","5","2","9","3","12","12",88,0.00910160574104447,9668.62359277512,"59"
"371830537262005","1","5","2","8","1","5","2","8","3","11","11",0,0.0182869514521306,0,"0"
"371830525033037","3","5","3","11","3","5","3","11","4","15","15",120,0.00615286348280092,19503.1143361844,"80"
"371830540141087","2","2","2","6","2","3","3","8","3","9","11",173,0.05719191517826,3024.9030734638,"58"
"371830541041034","2","2","1","5","2","2","2","6","3","8","9",7,0.0634738052374722,110.281713437711,"2"
"371830525061003","4","3","2","9","4","3","3","10","4","13","14",65,0.0723848578859592,897.977863027735,"28"
"371830537112025","4","5","2","11","4","5","2","11","4","15","15",50,0.021696603681648,2304.50814946176,"16"
"371830537151000","4","4","3","11","4","4","4","12","4","15","16",392,0.144702499692357,2709.00641546212,"149"
"371830537142025","4","3","3","10","4","3","3","10","4","14","14",5,0.00822732455861926,607.730977959513,"2"
"371830537191003","1","1","1","3","3","1","1","5","1","4","6",195,0.0312977475016077,6230.48032418254,"80"
"371830523023026","3","4","3","10","4","4","3","11","3","13","14",84,0.00832189568350396,10093.8539960923,"32"
"371830545004016","4","5","3","12","4","5","4","13","3","15","16",9,0.0345315131772361,260.631497780207,"3"
"371830521013000","3","4","4","11","3","4","5","12","4","15","16",243,0.13116552593051,1852.62094041951,"64"
"371830523023027","3","5","3","11","4","5","4","13","3","14","16",265,0.0363641676585984,7287.39352672465,"121"
"371830523013005","2","5","3","10","2","5","4","11","5","15","16",106,0.00701400911481756,15112.612239991,"53"
"371830525072023","1","1","2","4","1","1","2","4","5","9","9",56,0.0180468893452569,3103.02783646855,"23"
"371830527072011","2","3","3","8","2","3","4","9","2","10","11",46,0.0279182154995211,1647.66978035502,"22"
"371830530082005","1","3","2","6","1","3","2","6","2","8","8",198,2.02817795877761,97.624569453134,"68"
"371830528062049","2","1","2","5","2","2","3","7","2","7","9",131,0.00688539168869593,19025.7876273138,"25"
"371830525062004","2","2","2","6","2","2","3","7","3","9","10",258,0.0668776687592124,3857.78997364439,"91"
"371830521022000","5","4","5","14","5","4","5","14","3","17","17",1466,0.24965128184681,5872.19095834468,"447"
"371830528072073","4","2","1","7","4","4","2","10","2","9","12",313,0.0364986958893417,8575.64886561883,"92"
"371830528064011","2","1","1","4","2","1","1","4","4","8","8",69,0.00549705877666258,12552.1670412067,"19"
"371830537241035","2","5","2","9","2","5","2","9","3","12","12",2,0.00478551650498065,417.927719592743,"1"
"371830537111027","3","5","2","10","3","5","2","10","2","12","12",16,0.00563004186916087,2841.8971602399,"9"
"371830545002086","2","4","4","10","2","4","4","10","4","14","14",0,0.0092525445747534,0,"0"
"371830537241069","2","5","2","9","2","5","2","9","2","11","11",157,0.0367919225678309,4267.24098776163,"43"
"371839802001010","4","5","3","12","4","5","3","12","2","14","14",0,0.301147810893508,0,"0"
"371830521021014","4","4","5","13","4","4","5","13","5","18","18",0,0.0117205950104602,0,"0"
"371830526032010","3","3","4","10","3","3","5","11","4","14","15",65,0.0115999238392638,5603.48506599553,"28"
"371830526032016","4","3","4","11","4","3","5","12","4","15","16",42,0.0103012023475979,4077.19396074126,"18"
"371830541053015","4","2","1","7","4","2","2","8","4","11","12",103,0.00886564355908036,11617.8819183978,"55"
"371830526032000","4","3","4","11","4","4","5","13","5","16","18",44,0.0950956336561638,462.692116433971,"23"
"371830526032001","4","3","4","11","4","3","5","12","4","15","16",91,0.0215111950825952,4230.35538707138,"28"
"371830526032007","4","3","4","11","4","3","5","12","5","16","17",110,0.0257085026833506,4278.74004779121,"44"
"371830517001012","5","4","5","14","5","5","5","15","5","19","20",0,0.00891617969128433,0,"0"
"371830518003000","5","4","5","14","5","5","5","15","5","19","20",0,0.0314377960095412,0,"0"
"371830540151026","1","3","2","6","1","4","3","8","3","9","11",163,0.0527029463501688,3092.80621460887,"60"
"371830537191006","1","1","1","3","2","1","1","4","1","4","5",500,0.103066861556177,4851.21980480093,"167"
"371830537112017","3","5","2","10","3","5","2","10","3","13","13",11,0.00417938125552255,2631.96854449802,"3"
"371830541102042","1","1","1","3","3","2","2","7","3","6","10",267,0.52165751421339,511.830066135653,"133"
"371830525041013","3","5","4","12","3","5","4","12","5","17","17",0,0.00567461276742277,0,"0"
"371830524062000","1","4","3","8","2","4","3","9","3","11","12",0,0.0268952001703189,0,"0"
"371830515011007","4","3","4","11","4","3","5","12","5","16","17",0,0.00220133095712353,0,"0"
"371830540163013","2","5","2","9","2","5","3","10","4","13","14",169,0.0314236695754696,5378.11154085986,"70"
"371830540181021","2","3","3","8","2","3","4","9","2","10","11",276,0.0335003491691099,8238.72009831155,"138"
"371830540151013","5","4","3","12","5","4","3","12","2","14","14",99,0.0183118785787475,5406.32680444364,"36"
"371830524011085","3","5","4","12","3","5","4","12","3","15","15",0,0.0103176020091286,0,"0"
"371830541061022","1","3","4","8","2","3","4","9","4","12","13",0,0.00420152408904272,0,"0"
"371830545002017","3","4","4","11","3","4","5","12","4","15","16",0,0.0575993458344014,0,"0"
"371830521012000","4","4","5","13","4","4","5","13","4","17","17",29,0.0229858851925267,1261.64381998343,"14"
"371830521014029","5","5","5","15","5","5","5","15","4","19","19",74,0.0122614474115008,6035.17655922013,"30"
"371830521012004","4","4","5","13","4","4","5","13","3","16","16",170,0.0560261075729626,3034.29967499722,"66"
"371830537141011","4","2","3","9","4","2","3","9","4","13","13",44,0.0149409636338101,2944.92384014856,"17"
"371830525051030","4","4","4","12","4","4","5","13","5","17","18",0,0.00465525362225753,0,"0"
"371830537092019","2","5","2","9","2","5","2","9","3","12","12",125,0.0194029825145207,6442.30854233123,"74"
"371830545001039","4","5","5","14","4","5","5","14","5","19","19",0,0.0414689015698629,0,"0"
"371830524042003","3","5","4","12","3","5","4","12","5","17","17",0,0.00428303091518741,0,"0"
"371830524062013","1","4","2","7","5","4","3","12","3","10","15",155,0.00398729128088851,38873.5081239063,"64"
"371830537223007","3","2","2","7","3","2","3","8","3","10","11",142,0.0348168553309883,4078.4843619583,"58"
"371830540171018","1","4","3","8","1","4","3","8","2","10","10",525,0.0866629688530341,6057.95078276527,"218"
"371830540041003","3","3","4","10","3","3","4","10","2","12","12",49,0.00776821424467234,6307.75599856886,"24"
"371830537091004","2","5","2","9","2","5","2","9","3","12","12",77,0.0055652277540267,13835.9117368174,"39"
"371830540131021","2","5","2","9","2","5","2","9","4","13","13",675,0.148443484248691,4547.18510156469,"195"
"371830540151023","2","2","2","6","2","3","2","7","2","8","9",259,0.0383609108482197,6751.66450100129,"87"
"371830541043006","1","2","2","5","3","2","2","7","2","7","9",145,0.0168414001871185,8609.73543701588,"48"
"371830540141085","1","4","2","7","2","4","3","9","3","10","12",173,0.0423429569320053,4085.68537803831,"49"
"371830537112020","3","5","2","10","3","5","2","10","4","14","14",160,0.0391266877057033,4089.28047279294,"49"
"371830524041000","2","4","3","9","2","4","4","10","3","12","13",81,0.0592442977292521,1367.22019003706,"28"
"371830517001018","5","4","5","14","5","4","5","14","4","18","18",0,0.0128913668906097,0,"0"
"371830518001027","3","4","5","12","4","4","5","13","4","16","17",11,0.00243323050049616,4520.73899195205,"6"
"371830524071000","5","5","4","14","5","5","5","15","5","19","20",0,0.00025122848563556,0,"0"
"371830508002008","5","5","5","15","5","5","5","15","5","20","20",145,0.00571322522607087,25379.7101046059,"35"
"371830525051022","5","4","4","13","5","4","4","13","5","18","18",60,0.0303912162928386,1974.25464719352,"27"
"371830537163002","5","5","4","14","5","5","4","14","5","19","19",58,0.0143912685272247,4030.22151176448,"26"
"371830537163006","4","4","4","12","4","4","4","12","4","16","16",16,0.00542064618351705,2951.67761523568,"7"
"371830525033015","2","5","2","9","2","5","3","10","3","12","13",203,0.0346854164739435,5852.6037925045,"82"
"371830525042012","3","5","4","12","3","5","5","13","5","17","18",0,0.00597527728050469,0,"0"
"371830525042004","3","5","4","12","3","5","4","12","4","16","16",257,0.131832239605057,1949.44727306402,"154"
"371830525041003","2","5","3","10","2","5","4","11","4","14","15",147,0.0466179374886995,3153.29265769498,"68"
"371830541053001","1","1","1","3","1","1","1","3","4","7","7",50,0.0692026580963119,722.515599479042,"22"
"371830525031020","2","5","2","9","2","5","3","10","4","13","14",58,0.0163838721807182,3540.06668022343,"40"
"371830506001001","4","4","5","13","4","4","5","13","3","16","16",461,0.0409702546044604,11252.0657840826,"11"
"371830541053004","1","2","2","5","1","2","2","5","5","10","10",15,0.0257502980942893,582.517528343744,"5"
"371830541062038","4","3","2","9","4","4","3","11","5","14","16",44,0.0227678047199234,1932.55346930734,"18"
"371830527061026","3","4","4","11","3","4","5","12","3","14","15",82,0.022092470389846,3711.67182995019,"51"
"371830525043006","2","2","2","6","2","2","3","7","4","10","11",1,0.0188487906690642,53.0538015704775,"1"
"371830524011028","1","5","3","9","1","5","3","9","5","14","14",0,0.00198255462320539,0,"0"
"371830525031016","2","5","2","9","2","5","3","10","3","12","13",24,0.00480054916816961,4999.42801526412,"14"
"371830527011002","4","2","4","10","4","3","4","11","2","12","13",68,0.0171661255250017,3961.2899195547,"25"
"371830540043003","4","3","4","11","4","3","4","11","2","13","13",42,0.0125615103662992,3343.54697606112,"20"
"371830540133002","1","4","1","6","1","5","2","8","4","10","12",0,0.00100218395064115,0,"0"
"371830536102001","1","5","1","7","1","5","1","7","1","8","8",0,0.00747136008194246,0,"0"
"371830527063009","2","2","3","7","2","2","4","8","3","10","11",3,0.00775700011600787,386.747448128691,"2"
"371830527063022","1","2","3","6","1","3","4","8","3","9","11",0,0.00889457621213271,0,"0"
"371830536102005","1","5","1","7","1","5","1","7","1","8","8",0,0.0103837243948786,0,"0"
"371830525061007","2","3","3","8","2","3","3","8","3","11","11",176,0.0021587095121143,81530.1915391206,"148"
"371830537093001","5","5","3","13","5","5","3","13","2","15","15",1,0.0641603577747889,15.5859480009468,"1"
"371830528062004","3","2","2","7","3","3","3","9","4","11","13",7,0.0274595837922562,254.920105598033,"4"
"371830527071014","2","3","3","8","2","3","3","8","2","10","10",176,0.0228878043514304,7689.68474640953,"76"
"371830537231010","3","2","3","8","3","2","3","8","3","11","11",72,0.0103750631000343,6939.71682926558,"25"
"371830537222009","2","2","3","7","2","2","3","7","3","10","10",50,0.0429861834873254,1163.16443898172,"35"
"371830526032015","5","3","4","12","5","4","5","14","5","17","19",146,0.0353990342217046,4124.40630683877,"102"
"371830521021035","2","3","4","9","2","4","4","10","3","12","13",0,0.0191465714661489,0,"0"
"371830542091049","1","1","1","3","1","1","1","3","3","6","6",99,0.020689939527619,4784.93423665376,"29"
"371830524071024","3","5","4","12","3","5","4","12","3","15","15",0,0.00320857193842477,0,"0"
"371830524071025","4","5","4","13","4","5","5","14","3","16","17",0,0.0052135890507309,0,"0"
"371830537071001","3","2","3","8","3","2","4","9","4","12","13",121,0.0614437418055615,1969.28110893546,"61"
"371830537071002","3","2","3","8","3","2","4","9","4","12","13",85,0.0233992950421629,3632.58806929181,"38"
"371830537092029","1","5","1","7","1","5","1","7","2","9","9",4,0.0218669449217019,182.924501539774,"2"
"371830537141003","2","2","2","6","2","2","3","7","4","10","11",37,0.00792668637300376,4667.77645271956,"14"
"371830537141009","3","2","3","8","3","2","3","8","4","12","12",67,0.0143164812835752,4679.92090185364,"29"
"371830541062029","4","4","4","12","4","4","4","12","3","15","15",0,0.00286112812963081,0,"0"
"371830541041040","3","3","2","8","3","3","2","8","4","12","12",116,0.0172564415356536,6722.12748847044,"35"
"371830540143013","1","3","2","6","1","4","2","7","2","8","9",0,0.00972061254805869,0,"0"
"371830540134034","1","4","1","6","1","4","1","6","5","11","11",79,0.0109507267372451,7214.13307952515,"34"
"371830528062012","2","1","2","5","2","2","3","7","2","7","9",192,0.0218653197551181,8781.02868607982,"65"
"371830525041000","3","5","3","11","3","5","4","12","4","15","16",110,0.0306900270838925,3584.22622760516,"48"
"371830525043014","5","5","4","14","5","5","5","15","4","18","19",0,0.000882492602768981,0,"0"
"371830525042006","3","5","3","11","3","5","4","12","4","15","16",40,0.0129569536802735,3087.14540369921,"20"
"371830520024009","3","4","5","12","3","4","5","12","3","15","15",0,0.0211454105410095,0,"0"
"371830515011032","4","2","4","10","4","3","4","11","4","14","15",67,0.0378045108509097,1772.27527858326,"26"
"371830510001018","4","5","5","14","5","5","5","15","4","18","19",62,0.00517224662033642,11987.0540890734,"40"
"371830541054026","2","3","3","8","2","3","3","8","3","11","11",1,0.0205821970178552,48.58567815343,"1"
"371830515011011","5","3","4","12","5","3","5","13","4","16","17",82,0.0625838938045697,1310.24126201001,"29"
"371830505003014","5","4","5","14","5","5","5","15","5","19","20",42,0.0145637128797439,2883.87997942587,"23"
"371830519001022","5","4","5","14","5","5","5","15","3","17","18",39,0.0133474304531114,2921.91071060489,"14"
"371830542071100","3","4","1","8","3","5","1","9","3","11","12",80,0.0110331203507647,7250.89525507215,"21"
"371830519002006","4","4","5","13","4","4","5","13","4","17","17",404,0.0624064531956353,6473.68948742396,"144"
"371830519002009","4","4","5","13","4","4","5","13","4","17","17",56,0.0099987849785149,5600.68049471323,"19"
"371830528033030","3","2","4","9","3","2","4","9","2","11","11",7,0.0195117707230413,358.757803141554,"4"
"371830535171018","1","5","2","8","1","5","2","8","2","10","10",0,0.0142132881259303,0,"0"
"371830535161002","1","2","2","5","2","2","2","6","2","7","8",0,0.0299959006157813,0,"0"
"371830537222012","2","2","2","6","2","2","2","6","3","9","9",79,0.0102957047171239,7673.10273269652,"30"
"371830537071004","4","2","3","9","4","2","3","9","4","13","13",0,0.0025711771736789,0,"0"
"371830541052035","2","3","3","8","2","3","3","8","3","11","11",22,0.00604268320300098,3640.76673572332,"12"
"371830514003002","4","5","4","13","5","5","5","15","5","18","20",29,0.00812010580760635,3571.38203455857,"14"
"371830537071020","4","2","3","9","4","2","3","9","4","13","13",0,0.0263573845925455,0,"0"
"371830537211020","2","1","1","4","2","1","2","5","3","7","8",93,0.115419625565955,805.755516394881,"28"
"371830537241038","2","5","2","9","2","5","2","9","2","11","11",71,0.0108651794015071,6534.63669363358,"38"
"371830523022014","4","5","4","13","5","5","4","14","3","16","17",283,0.0577704302271282,4898.69988655731,"108"
"371830537241006","2","5","1","8","2","5","1","8","1","9","9",0,0.824345009472593,0,"0"
"371830541063003","2","2","2","6","2","2","2","6","3","9","9",156,0.0178943756717815,8717.82301105948,"54"
"371830540171030","3","3","3","9","3","3","3","9","2","11","11",182,0.0441719095957586,4120.26560919783,"78"
"371830540151041","4","4","3","11","4","4","3","11","3","14","14",6,0.028289402857141,212.093554264807,"2"
"371830520022013","5","4","5","14","5","4","5","14","5","19","19",55,0.0277860481030763,1979.41066667594,"19"
"371830518002024","5","4","5","14","5","4","5","14","3","17","17",54,0.00933071215340285,5787.33960626002,"20"
"371830503001023","5","5","5","15","5","5","5","15","3","18","18",42,0.00769175315220679,5460.39364094128,"24"
"371830503001008","4","4","5","13","4","5","5","14","3","16","17",0,0.009384312793304,0,"0"
"371830530081042","2","4","2","8","2","4","2","8","3","11","11",163,0.0527020481180572,3092.85892713061,"53"
"371830523013007","2","5","3","10","2","5","4","11","3","13","14",28,0.0390452187226705,717.117253174525,"12"
"371830523022017","5","5","4","14","5","5","4","14","3","17","17",188,0.0263207287261527,7142.65938287644,"20"
"371830523023036","2","5","3","10","2","5","3","10","3","13","13",3,0.00406685082688009,737.671512358241,"2"
"371830537241055","2","5","2","9","2","5","2","9","2","11","11",32,0.00518163039856035,6175.66239554461,"11"
"371830541061040","2","3","4","9","2","3","4","9","4","13","13",0,0.00164326294203771,0,"0"
"371830503001014","5","5","5","15","5","5","5","15","3","18","18",46,0.00651627398511389,7059.24890590616,"24"
"371830503001007","4","4","5","13","4","5","5","14","3","16","17",25,0.005086624748425,4914.85046301889,"14"
"371830538083031","3","5","2","10","3","5","2","10","4","14","14",4,0.00225700259269463,1772.26203148682,"3"
"371830542071059","1","2","1","4","1","2","1","4","2","6","6",39,0.00173993180752631,22414.6715585635,"13"
"371830512003005","5","5","5","15","5","5","5","15","4","19","19",60,0.0081779171740159,7336.83146004963,"32"
"371830524081005","3","5","4","12","3","5","4","12","4","16","16",29,0.0171271166855127,1693.22137126152,"11"
"371830524081008","3","5","4","12","3","5","4","12","3","15","15",0,0.00358644000202089,0,"0"
"371830526031013","4","3","4","11","4","3","5","12","5","16","17",318,0.147195459634814,2160.39272399396,"122"
"371830537232004","2","2","3","7","2","2","3","7","4","11","11",94,0.0198687247243981,4731.05351772131,"53"
"371830537072011","4","4","4","12","4","4","4","12","4","16","16",90,0.0171262851802803,5255.08007443602,"44"
"371830541061000","1","1","1","3","1","2","2","5","3","6","8",616,0.558043777770451,1103.85604953988,"196"
"371830541043020","2","3","2","7","3","3","3","9","3","10","12",670,0.243050241794228,2756.63169496963,"190"
"371830541042025","5","5","3","13","5","5","3","13","5","18","18",129,0.0147737532264571,8731.70128285238,"47"
"371830540143036","2","2","2","6","2","3","2","7","3","9","10",39,0.00609638052424299,6397.2384671383,"15"
"371830540141072","2","3","1","6","2","4","2","8","4","10","12",9,0.00521350799054615,1726.28487696193,"5"
"371830511021003","5","5","5","15","5","5","5","15","4","19","19",0,0.00254667893070593,0,"0"
"371830526012018","5","3","4","12","5","3","5","13","5","17","18",91,0.0399209190524663,2279.50663862229,"35"
"371830527072008","3","3","3","9","3","3","4","10","2","11","12",38,0.0159010582853096,2389.77804610067,"21"
"371830527072024","3","4","3","10","3","4","4","11","2","12","13",72,0.0199264278956761,3613.29187433657,"27"
"371830517003021","3","4","4","11","4","4","5","13","3","14","16",57,0.0553930268159945,1029.01038770356,"38"
"371830541061003","3","2","2","7","3","2","2","7","3","10","10",75,0.00732106919564807,10244.4052904981,"27"
"371830516001001","3","4","4","11","5","4","5","14","3","14","17",409,0.127784436415593,3200.70277314374,"236"
"371830517003026","3","3","4","10","5","3","5","13","4","14","17",65,0.0368257709271687,1765.06827592428,"27"
"371830506002010","5","4","5","14","5","5","5","15","4","18","19",33,0.00638694756037995,5166.78737190647,"15"
"371830506002030","5","4","5","14","5","5","5","15","4","18","19",11,0.00461583571260934,2383.10041450363,"4"
"371830506002017","5","4","5","14","5","5","5","15","4","18","19",21,0.00458289271347958,4582.25869836164,"13"
"371830507003044","4","4","5","13","4","4","5","13","5","18","18",25,0.0180627354383039,1384.06500418452,"11"
"371830508001000","5","5","5","15","5","5","5","15","4","19","19",61,0.00542339473701795,11247.5677980137,"27"
"371830515012015","3","2","4","9","3","2","4","9","4","13","13",55,0.0192791440677182,2852.8237460549,"24"
"371830528033009","1","2","2","5","4","3","3","10","3","8","13",128,0.014670159474112,8725.1948573482,"39"
"371830521012003","4","4","5","13","4","4","5","13","3","16","16",37,0.0126273345010961,2930.15125217346,"16"
"371830536101071","4","1","2","7","4","1","2","7","1","8","8",15,0.00761824689754421,1968.95692693228,"7"
"371830536101013","1","5","1","7","1","5","1","7","1","8","8",89,0.0145078924364891,6134.59193949869,"32"
"371830536101060","2","5","1","8","2","5","1","8","1","9","9",0,0.0016678868873069,0,"0"
"371830517003023","3","3","4","10","5","3","5","13","4","14","17",40,0.0118748332031663,3368.46836630382,"15"
"371830527052027","2","2","4","8","2","2","5","9","4","12","13",659,0.162036726044229,4066.97923420226,"408"
"371830537093051","2","5","1","8","2","5","1","8","2","10","10",116,0.0250993706208911,4621.62983096672,"36"
"371830537092026","2","5","2","9","2","5","2","9","3","12","12",7,0.00120558940800942,5806.28857013426,"2"
"371830540162014","2","4","2","8","2","4","2","8","2","10","10",45,0.00223140147410652,20166.6981590655,"21"
"371830537181018","1","1","1","3","4","1","1","6","1","4","7",126,0.0882329248590479,1428.0383451108,"47"
"371830540171034","3","4","4","11","3","4","4","11","2","13","13",32,0.0194759695000205,1643.05042683325,"14"
"371830540143030","2","2","2","6","2","3","3","8","3","9","11",99,0.00913011006431384,10843.2427761144,"30"
"371830541061038","1","3","4","8","2","3","4","9","4","12","13",0,0.00151236123229513,0,"0"
"371830540111010","1","4","3","8","1","4","3","8","3","11","11",177,0.13067757587486,1354.47875287723,"63"
"371830540082002","4","3","3","10","4","3","3","10","2","12","12",189,0.0124903550139734,15131.6755839653,"88"
"371830540151024","2","3","2","7","2","3","3","8","3","10","11",48,0.0063233555067658,7590.90643387699,"15"
"371830540122007","5","5","4","14","5","5","4","14","2","16","16",69,0.00973197488260514,7090.03062917169,"25"
"371830540142001","5","3","2","10","5","4","2","11","4","14","15",287,0.0276332358975571,10386.043859068,"97"
"371830507002012","4","5","5","14","4","5","5","14","5","19","19",203,0.037370461728476,5432.09772132186,"74"
"371830506001008","5","4","5","14","5","5","5","15","3","17","18",94,0.00635628163050181,14788.520311769,"31"
"371830507001022","5","5","5","15","5","5","5","15","5","20","20",75,0.00610372551803328,12287.5774440405,"26"
"371830537142027","3","3","3","9","3","3","3","9","4","13","13",62,0.00179516568369851,34537.2020883686,"28"
"371830541103039","1","1","1","3","5","2","2","9","3","6","12",12,0.0751205756701861,159.743184779168,"6"
"371830541103013","1","2","1","4","1","2","2","5","3","7","8",0,0.0415714033352363,0,"0"
"371830515022013","4","4","4","12","4","5","5","14","5","17","19",50,0.0104662659136625,4777.25297756202,"20"
"371830541052016","2","3","3","8","2","3","3","8","2","10","10",852,0.13781801467618,6182.06554492804,"324"
"371830524011091","1","5","2","8","2","5","2","9","3","11","12",0,0.00194060996787057,0,"0"
"371830540171052","1","3","2","6","1","3","2","6","2","8","8",0,0.0462226563357312,0,"0"
"371830507001005","5","5","5","15","5","5","5","15","5","20","20",46,0.00618048669567504,7442.77955200353,"22"
"371830537122013","3","2","2","7","3","2","3","8","4","11","12",57,0.0240342637492656,2371.61415030829,"23"
"371830545004004","2","4","3","9","2","4","3","9","2","11","11",96,0.0197200383264105,4868.14469683002,"38"
"371830523021041","3","5","4","12","3","5","5","13","5","17","18",0,0.0972902658148742,0,"0"
"371830528033020","2","2","4","8","2","3","4","9","3","11","12",4,0.00546164024257078,732.380717576742,"2"
"371830528072004","1","1","2","4","2","2","2","6","3","7","9",0,0.00344917426297884,0,"0"
"371830521014008","4","4","5","13","4","5","5","14","4","17","18",11,0.00253895887779974,4332.48450622115,"9"
"371830540082003","4","3","3","10","4","3","3","10","2","12","12",213,0.0119281615025373,17856.9010785686,"66"
"371830523021045","2","5","4","11","2","5","4","11","4","15","15",0,0.00560401514901922,0,"0"
"371830530081031","2","4","2","8","2","4","2","8","3","11","11",26,0.000741202886792491,35078.1148634126,"18"
"371830537131012","4","5","3","12","4","5","3","12","5","17","17",35,0.00403477526941842,8674.58474460337,"26"
"371830537121002","3","1","2","6","3","1","2","6","3","9","9",255,0.0539489764491883,4726.68837823403,"93"
"371830537252035","1","5","2","8","1","5","2","8","3","11","11",161,0.00174765634498928,92123.374519026,"95"
"371830537252024","1","5","2","8","1","5","2","8","3","11","11",79,0.020682289971959,3819.69308558714,"46"
"371830537111018","3","5","2","10","3","5","2","10","2","12","12",0,0.0216160129527978,0,"0"
"371830537241067","1","5","2","8","1","5","2","8","2","10","10",190,0.0226962586060606,8371.42382353997,"85"
"371830545004013","5","5","4","14","5","5","4","14","3","17","17",162,0.0611480177311602,2649.30910290894,"69"
"371830524041023","5","5","4","14","5","5","4","14","5","19","19",0,0.0338157160411844,0,"0"
"371830523011018","5","5","3","13","5","5","3","13","5","18","18",0,0.000535042548739888,0,"0"
"371830536102017","4","5","2","11","4","5","2","11","1","12","12",63,0.00630329777679288,9994.76817229702,"24"
"371830525072010","2","2","2","6","2","2","2","6","3","9","9",73,0.00319642761995928,22837.9956249189,"24"
"371830525072027","1","1","2","4","1","1","2","4","5","9","9",40,0.0174394799288595,2293.64637954637,"19"
"371830545001053","4","5","5","14","4","5","5","14","5","19","19",0,0.00741422558374731,0,"0"
"371830518002016","4","4","5","13","5","5","5","15","3","16","18",27,0.00751016848422376,3595.12573608935,"11"
"371830540163018","4","5","3","12","4","5","3","12","5","17","17",104,0.0176917431217913,5878.4484538384,"50"
"371830528062040","2","1","2","5","4","3","3","10","5","10","15",0,0.00996189297608517,0,"0"
"371830514003006","5","5","5","15","5","5","5","15","5","20","20",67,0.0157391441007696,4256.90238116086,"33"
"371830541131008","1","1","1","3","4","3","2","9","5","8","14",1,0.177860810435086,5.62237402131353,"1"
"371830540181028","4","4","4","12","4","4","4","12","2","14","14",203,0.0214934050085951,9444.75758581858,"77"
"371830537112026","5","3","3","11","5","3","3","11","5","16","16",18,0.0492187163530981,365.714535723908,"7"
"371830537171015","1","5","1","7","3","5","2","10","1","8","11",621,0.248214933165103,2501.86397764769,"268"
"371830537262013","2","5","2","9","2","5","2","9","4","13","13",92,0.0364912236835438,2521.15414922324,"36"
"371830537112018","4","5","2","11","4","5","2","11","4","15","15",141,0.0309340114802752,4558.08972883802,"46"
"371830514004016","5","5","5","15","5","5","5","15","5","20","20",22,0.0072041958504119,3053.77594624141,"19"
"371830540181011","2","3","3","8","2","3","3","8","2","10","10",0,0.00454075307959811,0,"0"
"371830540083008","2","2","3","7","4","3","3","10","2","9","12",164,0.0122556564032836,13381.5761966091,"76"
"371830540141060","3","3","1","7","3","4","2","9","4","11","13",0,0.000643249142307758,0,"0"
"371830540143000","2","4","2","8","2","4","3","9","2","10","11",1357,0.2542138165496,5338.02614829644,"469"
"371830540143012","1","3","2","6","1","4","2","7","2","8","9",115,0.0234723853428672,4899.37423573127,"45"
"371830537241060","2","5","2","9","2","5","2","9","2","11","11",0,0.00566560177634518,0,"0"
"371830537132000","5","3","3","11","5","3","3","11","5","16","16",56,0.00849135949336825,6594.93924897845,"15"
"371830537111022","2","5","2","9","2","5","2","9","2","11","11",0,0.00438684941779868,0,"0"
"371830525033008","1","5","2","8","1","5","2","8","5","13","13",2,0.00505480521684691,395.663119388716,"1"
"371830527071002","2","2","3","7","3","3","3","9","2","9","11",342,0.194345851494711,1759.74942284429,"136"
"371830540141094","3","4","2","9","3","5","2","10","4","13","14",63,0.00673605263811946,9352.65850558852,"19"
"371830540132039","1","4","1","6","1","4","1","6","5","11","11",201,0.0256301586914894,7842.32366328433,"50"
"371830527012016","2","3","4","9","2","3","4","9","2","11","11",0,0.00138793812990132,0,"0"
"371830540111001","2","5","3","10","2","5","3","10","4","14","14",165,0.0594203128540133,2776.82819350649,"56"
"371830524063007","1","5","2","8","1","5","2","8","2","10","10",0,0.0107434894345399,0,"0"
"371830501001029","4","5","5","14","4","5","5","14","4","18","18",0,0.0059046475091875,0,"0"
"371830527073042","1","2","2","5","1","2","3","6","3","8","9",0,0.00795399177803821,0,"0"
"371830515022007","5","3","4","12","5","3","5","13","4","16","17",74,0.0206796339130258,3578.39990355866,"43"
"371830501001093","5","5","5","15","5","5","5","15","5","20","20",86,0.00853433757819667,10076.9390959775,"58"
"371830501001046","5","5","5","15","5","5","5","15","5","20","20",64,0.00483588454006033,13234.3937225601,"28"
"371830508002013","4","5","5","14","4","5","5","14","4","18","18",0,0.0638841230172415,0,"0"
"371830509001018","5","5","5","15","5","5","5","15","5","20","20",62,0.00492882024340106,12579.0751007827,"23"
"371830541063000","4","2","2","8","4","3","2","9","4","12","13",1060,0.384626956746033,2755.91708123545,"386"
"371830540132050","2","4","1","7","2","5","2","9","4","11","13",26,0.00345073514178802,7534.62637139052,"11"
"371830515012031","3","4","4","11","3","4","5","12","3","14","15",19,0.00808123086136313,2351.12699116668,"7"
"371830521011032","2","2","3","7","2","2","4","8","2","9","10",10,0.00612933201934486,1631.49915332354,"6"
"371830519002019","5","5","5","15","5","5","5","15","4","19","19",245,0.0285886616689306,8569.83103431734,"77"
"371830540163008","3","5","3","11","3","5","3","11","5","16","16",639,0.148808049111074,4294.12255464109,"314"
"371830540141002","1","2","1","4","1","3","2","6","3","7","9",0,0.00607077327637016,0,"0"
"371830521021019","5","3","4","12","5","3","5","13","3","15","16",441,0.0739329113609611,5964.86722735583,"157"
"371830541061008","3","3","2","8","3","3","2","8","3","11","11",44,0.00409426398761956,10746.7423041234,"12"
"371830541062007","3","2","2","7","3","3","3","9","3","10","12",0,0.0224220488520949,0,"0"
"371830525033006","2","5","2","9","2","5","2","9","3","12","12",200,0.0701555752498195,2850.80692857001,"65"
"371830515011003","5","4","4","13","5","4","5","14","5","18","19",0,0.00408984817087048,0,"0"
"371830524011037","1","5","2","8","1","5","3","9","4","12","13",5,0.0348237412916913,143.580207483133,"2"
"371830541054004","4","3","2","9","4","3","3","10","2","11","12",698,0.286351823408307,2437.56087072205,"267"
"371830527073034","1","4","3","8","1","4","4","9","3","11","12",0,0.00525508145344666,0,"0"
"371830540161002","3","4","2","9","3","4","2","9","4","13","13",189,0.0183785892315236,10283.7055455715,"62"
"371830527043009","5","3","4","12","5","3","4","12","2","14","14",37,0.00625659952778442,5913.75552098065,"11"
"371830541042016","2","2","2","6","2","2","2","6","3","9","9",340,0.0320873244953551,10596.0844460316,"80"
"371830541052023","3","4","3","10","3","4","4","11","3","13","14",0,0.000873417310674007,0,"0"
"371830541052024","3","4","3","10","3","4","4","11","3","13","14",0,0.00249964385393003,0,"0"
"371830521014032","5","5","5","15","5","5","5","15","4","19","19",85,0.0143796251030295,5911.14159033895,"34"
"371830527062008","3","2","4","9","3","2","5","10","4","13","14",0,0.0105053241057761,0,"0"
"371830540181034","3","4","4","11","3","4","4","11","2","13","13",2,0.0169727430604232,117.835991087591,"1"
"371830540133004","1","4","1","6","1","5","2","8","4","10","12",0,0.000994167056431355,0,"0"
"371830540171031","2","3","3","8","2","3","3","8","2","10","10",120,0.00726315148903353,16521.7537017072,"42"
"371830524081007","3","4","4","11","3","4","4","11","3","14","14",0,0.00428402736193515,0,"0"
"371830541062005","3","2","2","7","3","2","3","8","3","10","11",517,0.186742392221301,2768.51974450088,"194"
"371830527052013","3","2","4","9","3","2","4","9","3","12","12",85,0.0900868955310167,943.533457324375,"33"
"371830540112000","2","4","3","9","2","4","3","9","3","12","12",124,0.0475981522319952,2605.14314496116,"45"
"371830525033012","3","5","3","11","3","5","3","11","5","16","16",0,0.000815032415360269,0,"0"
"371830525033029","4","5","3","12","4","5","4","13","4","16","17",112,0.010829163364756,10342.4425532732,"105"
"371830527013009","2","3","4","9","2","3","5","10","4","13","14",0,0.00746696924130831,0,"0"
"371830505003013","5","5","5","15","5","5","5","15","4","19","19",94,0.0239091196901505,3931.55420267205,"40"
"371830506001004","5","4","5","14","5","5","5","15","3","17","18",115,0.00864910825940501,13296.1684084541,"47"
"371830541063008","3","3","2","8","3","3","2","8","4","12","12",95,0.0126845459418133,7489.42850897346,"32"
"371830541131021","1","1","1","3","5","3","2","10","5","8","15",126,0.0111551676749773,11295.2134536388,"43"
"371830537252042","1","5","2","8","1","5","2","8","3","11","11",0,0.00386540623433169,0,"0"
"371830537221002","3","2","2","7","3","2","3","8","3","10","11",37,0.0125718214125543,2943.08985037376,"13"
"371830542071104","3","5","1","9","3","5","1","9","4","13","13",97,0.0106642200585695,9095.83630750883,"29"
"371830514004001","4","5","5","14","4","5","5","14","4","18","18",137,0.0180817200716725,7576.71280480828,"80"
"371830514002011","4","5","5","14","4","5","5","14","4","18","18",84,0.0121685040253604,6903.06711695499,"33"
"371830516002016","4","4","4","12","4","4","5","13","3","15","16",43,0.0152676707524098,2816.4086518052,"19"
"371830514001002","5","5","5","15","5","5","5","15","3","18","18",43,0.0105034661733108,4093.88665517508,"20"
"371830537181016","1","1","1","3","2","1","1","4","1","4","5",1,0.105590305527401,9.4705664029024,"1"
"371830537191000","1","1","1","3","2","1","1","4","1","4","5",230,0.0283223363674261,8120.79896997925,"89"
"371830514001014","5","5","5","15","5","5","5","15","4","19","19",95,0.0163909226577755,5795.89093204182,"45"
"371830508001013","5","5","5","15","5","5","5","15","5","20","20",86,0.00792134337928609,10856.7443528437,"36"
"371830516002022","5","4","4","13","5","4","5","14","3","16","17",30,0.0117269970778881,2558.19966533178,"13"
"371830507001001","5","5","5","15","5","5","5","15","5","20","20",37,0.00948163111307078,3902.28216630303,"17"
"371830528033054","2","2","2","6","3","3","3","9","4","10","13",0,0.00359163791064347,0,"0"
"371830528072027","3","1","1","5","3","2","1","6","2","7","8",60,0.00553514097097908,10839.8323212691,"15"
"371830541051002","1","1","1","3","1","1","2","4","3","6","7",60,0.00416364044045578,14410.4662393547,"23"
"371830537152012","3","3","3","9","3","3","3","9","4","13","13",191,0.108935374126922,1753.3331255416,"77"
"371830537072003","4","2","3","9","4","2","3","9","5","14","14",65,0.0156304709778424,4158.543916696,"25"
"371830537222008","2","2","3","7","2","2","3","7","3","10","10",55,0.00210777850113812,26093.8234118539,"31"
"371830516002013","4","4","4","12","4","4","5","13","3","15","16",144,0.0515826116631073,2791.63840986732,"48"
"371830537093000","4","5","3","12","4","5","3","12","2","14","14",43,0.0562899511634099,763.901888547938,"0"
"371830536101056","2","5","1","8","2","5","1","8","1","9","9",33,0.0499273207318027,660.960762891081,"12"
"371830515021000","4","5","4","13","4","5","5","14","5","18","19",19,0.0109064656240047,1742.0859016125,"8"
"371830515012021","3","4","4","11","3","4","5","12","4","15","16",62,0.0228209264908623,2716.80468471889,"23"
"371830515022014","4","4","4","12","4","5","5","14","5","17","19",48,0.0159033111126028,3018.23938802038,"24"
"371830515022027","4","4","4","12","4","5","5","14","5","17","19",62,0.0180197237530295,3440.67427723893,"31"
"371830514003005","4","5","4","13","5","5","5","15","5","18","20",26,0.00577360926482654,4503.24897432787,"11"
"371830528033046","1","1","2","4","1","2","2","5","3","7","8",302,0.0428801012833151,7042.89381232199,"69"
"371830528072068","4","2","2","8","4","5","2","11","2","10","13",64,0.0129250078503454,4951.64109306826,"23"
"371830528061019","1","2","2","5","3","3","3","9","3","8","12",0,0.00095936864437878,0,"0"
"371830545002040","2","2","3","7","2","2","3","7","3","10","10",0,0.0703193908582235,0,"0"
"371830528072006","3","1","2","6","3","3","2","8","3","9","11",31,0.0439964115194956,704.602919405446,"6"
"371830528072013","4","3","2","9","4","4","3","11","3","12","14",0,0.00308760031585141,0,"0"
"371830528072024","3","1","1","5","3","3","2","8","2","7","10",16,0.0767117775039192,208.57292739935,"7"
"371830523021023","2","5","3","10","2","5","4","11","5","15","16",35,0.0844400313845867,414.495345703871,"16"
"371830540112008","2","4","3","9","2","4","3","9","3","12","12",118,0.0328648824669371,3590.45860330433,"45"
"371830506002020","5","4","5","14","5","5","5","15","3","17","18",32,0.00481337880396722,6648.13664231566,"15"
"371830507003021","5","4","5","14","5","5","5","15","4","18","19",50,0.0067762807477433,7378.67893337381,"21"
"371830508002011","5","5","5","15","5","5","5","15","5","20","20",156,0.0688145881265584,2266.96118144451,"46"
"371830504001030","3","5","5","13","5","5","5","15","3","16","18",0,0.00207596606043625,0,"0"
"371830517001003","5","4","4","13","5","4","5","14","5","18","19",153,0.125511319244185,1219.0135592658,"58"
"371830516004000","3","4","5","12","4","4","5","13","3","15","16",26,0.00944364893296819,2753.1730779649,"12"
"371830527012039","2","3","4","9","2","3","5","10","4","13","14",0,0.00820450428894682,0,"0"
"371830536101021","1","5","1","7","1","5","1","7","1","8","8",134,0.0109538809251463,12233.107235298,"67"
"371830519002017","4","4","5","13","4","4","5","13","4","17","17",46,0.0105098013557653,4376.86674018495,"25"
"371830519001009","4","4","5","13","5","4","5","14","4","17","18",79,0.0303964264630622,2598.98972321634,"32"
"371830519003005","5","2","4","11","5","2","5","12","5","16","17",41,0.0114880570249215,3568.92378850985,"22"
"371830519001007","3","3","4","10","5","4","5","14","4","14","18",91,0.0248632586742331,3660.01903420276,"34"
"371830524072020","3","4","3","10","3","4","3","10","3","13","13",0,0.00330764701955567,0,"0"
"371830515011027","3","3","4","10","3","3","5","11","3","13","14",92,0.0636888865190635,1444.52203560605,"40"
"371830536102013","4","5","1","10","4","5","2","11","1","11","12",47,0.00200015988404733,23498.121512614,"25"
"371830540151019","3","3","2","8","3","3","3","9","2","10","11",761,0.132073913660723,5761.92511380322,"279"
"371830507003028","5","5","5","15","5","5","5","15","4","19","19",24,0.00474578697503562,5057.1170021427,"8"
"371830516002007","3","4","4","11","3","4","5","12","3","14","15",68,0.0165022395151742,4120.65283245177,"37"
"371830526031010","4","3","4","11","4","3","5","12","4","15","16",18,0.00837331960619359,2149.68505282967,"9"
"371830540043015","2","3","4","9","2","4","4","10","2","11","12",341,0.0635172957685247,5368.61646696519,"133"
"371830517002004","3","4","4","11","5","5","5","15","4","15","19",42,0.0161707140028562,2597.28791150357,"17"
"371830516003012","4","4","5","13","5","5","5","15","3","16","18",60,0.010408097279759,5764.742429597,"26"
"371830512002007","5","5","5","15","5","5","5","15","3","18","18",111,0.0252169727546758,4401.7971974617,"65"
"371830516001004","2","3","4","9","3","4","5","12","3","12","15",31,0.00362185330697619,8559.15393930774,"21"
"371830516005003","4","4","5","13","4","4","5","13","3","16","16",45,0.0106698995731066,4217.471747665,"18"
"371830516005005","4","4","5","13","5","5","5","15","3","16","18",35,0.010294189016128,3399.97642797944,"13"
"371830528072003","1","1","2","4","1","2","2","5","3","7","8",0,0.0660111439245915,0,"0"
"371830528072016","4","2","1","7","4","3","2","9","2","9","11",181,0.0455051577429064,3977.57109254754,"60"
"371830524072018","4","5","4","13","5","5","4","14","3","16","17",176,0.0589687313959153,2984.6326321375,"79"
"371830524071020","3","5","3","11","3","5","4","12","3","14","15",0,0.00504464834764659,0,"0"
"371830541101012","2","1","1","4","2","2","1","5","3","7","8",221,0.0519031281118678,4257.93219097844,"73"
"371830542081123","2","4","1","7","2","5","1","8","3","10","11",79,0.0101410529645542,7790.11807512763,"25"
"371830541103008","2","1","1","4","2","2","1","5","3","7","8",146,0.0119994232701605,12167.2514347473,"39"
"371830541101002","3","2","1","6","3","3","1","7","4","10","11",131,0.0282984895986377,4629.22233158007,"54"
"371830521021026","4","4","4","12","4","4","5","13","4","16","17",168,0.0333817263316296,5032.69358603597,"65"
"371830521022004","4","2","4","10","4","2","4","10","3","13","13",0,0.0070512680941495,0,"0"
"371830528033039","4","2","4","10","4","2","4","10","2","12","12",2,0.0521570486657361,38.3457279727922,"1"
"371830516002005","3","4","4","11","4","4","5","13","3","14","16",0,0.000488961660611769,0,"0"
"371830527063024","1","2","3","6","1","3","4","8","3","9","11",10,0.0462761716468146,216.093934397193,"3"
"371830542071069","1","2","1","4","1","2","1","4","2","6","6",119,0.0145151639936483,8198.32280586517,"33"
"371830541053024","3","2","1","6","3","2","2","7","4","10","11",0,0.0215521958118861,0,"0"
"371830528062007","3","2","2","7","3","4","4","11","4","11","15",71,0.076800088915451,924.478096349129,"27"
"371830524011008","2","5","2","9","2","5","2","9","3","12","12",0,0.00313454737115467,0,"0"
"371830536102018","4","5","2","11","4","5","2","11","1","12","12",58,0.00222848766739147,26026.6192398952,"33"
"371830525051004","2","3","3","8","2","3","4","9","5","13","14",110,0.0148504635693283,7407.17617914574,"64"
"371830524071018","3","5","4","12","4","5","4","13","3","15","16",294,0.0414332581403437,7095.74899961178,"140"
"371830537252047","1","5","2","8","1","5","2","8","3","11","11",66,0.0111642089689839,5911.74889178083,"36"
"371830537132002","4","3","3","10","4","3","3","10","4","14","14",0,0.00300006393830742,0,"0"
"371830537111037","5","3","3","11","5","3","3","11","5","16","16",5,0.00600038800380766,833.279447400261,"1"
"371830537252030","1","5","2","8","1","5","2","8","3","11","11",0,0.000480293995557962,0,"0"
"371830537121020","4","1","2","7","4","1","2","7","4","11","11",1,0.00108069204398429,925.332989695384,"1"
"371830541042000","3","3","2","8","3","3","2","8","5","13","13",71,0.0573450148255477,1238.11982987524,"28"
"371830540043014","2","3","3","8","2","3","4","9","2","10","11",41,0.00320151751054534,12806.4269100362,"28"
"371830540163003","4","5","3","12","4","5","3","12","5","17","17",91,0.0136619601400204,6660.83044214356,"31"
"371830527061025","3","3","3","9","3","3","4","10","2","11","12",38,0.018538547377749,2049.78303993816,"15"
"371830527012018","3","3","4","10","3","3","4","10","2","12","12",0,0.0367324023180399,0,"0"
"371830527042007","4","4","4","12","4","4","4","12","2","14","14",430,0.0228511625589195,18817.423353901,"199"
"371830541041014","1","3","1","5","2","4","2","8","4","9","12",43,0.00755333707966145,5692.84801492367,"14"
"371830524072011","3","4","3","10","3","4","3","10","3","13","13",59,0.0110550536662084,5336.92569764211,"24"
"371830505003002","3","4","5","12","4","4","5","13","5","17","18",0,0.00125054194544303,0,"0"
"371830519001003","2","3","4","9","3","3","5","11","5","14","16",0,0.00129880589567429,0,"0"
"371830541054000","2","3","2","7","3","3","3","9","3","10","12",46,0.0263423563954719,1746.23709851208,"26"
"371830527071016","3","3","4","10","3","3","4","10","2","12","12",0,9.2496148853022e-05,0,"0"
"371830541042015","5","5","3","13","5","5","3","13","4","17","17",32,0.00577874111183398,5537.53825975503,"8"
"371830527071013","3","3","3","9","3","3","3","9","2","11","11",32,0.00503065946989983,6360.99505272958,"12"
"371830511012013","4","4","4","12","4","5","5","14","4","16","18",27,0.0107063077081822,2521.87782529037,"9"
"371830541132012","1","1","1","3","2","2","1","5","3","6","8",0,0.0464400187166204,0,"0"
"371830521012007","5","4","5","14","5","4","5","14","3","17","17",39,0.00848793805067406,4594.75549505252,"13"
"371830528033061","1","1","2","4","1","2","2","5","3","7","8",0,0.019369766996519,0,"0"
"371830541043015","3","3","3","9","4","4","3","11","2","11","13",96,0.0135052442075843,7108.34980281869,"37"
"371830541041035","2","2","2","6","3","3","3","9","2","8","11",259,0.0463811709385445,5584.16259786061,"84"
"371830528072040","1","1","1","3","1","1","1","3","2","5","5",16,1.57224072622243,10.176558673965,"7"
"371830540141059","3","3","2","8","3","4","2","9","4","12","13",58,0.00843470897726095,6876.34868687961,"19"
"371830536102037","5","5","2","12","5","5","2","12","1","13","13",0,0.0156089992952014,0,"0"
"371830535211017","3","5","2","10","3","5","2","10","4","14","14",0,0.00852774536367636,0,"0"
"371830537192004","1","1","1","3","2","1","1","4","1","4","5",368,0.0910247615774847,4042.85596163567,"124"
"371830537191013","1","1","1","3","2","1","1","4","1","4","5",86,0.0118324257331329,7268.16309179824,"27"
"371830540141052","2","3","1","6","3","4","2","9","4","10","13",52,0.00361887518277909,14369.1056954518,"28"
"371830540141009","1","2","1","4","3","3","2","8","3","7","11",37,0.00287462753514878,12871.2327240979,"15"
"371830537141015","2","3","3","8","2","3","3","8","4","12","12",147,0.0289324472028682,5080.80076909039,"54"
"371830545001005","5","5","5","15","5","5","5","15","5","20","20",2,0.0172869277405025,115.694357610698,"1"
"371830521014014","5","5","5","15","5","5","5","15","5","20","20",3,0.0446332311065605,67.2144930049449,"2"
"371830521014015","5","5","5","15","5","5","5","15","5","20","20",0,0.0442994721020885,0,"0"
"371830526011027","4","3","3","10","4","3","4","11","4","14","15",263,0.10027521852021,2622.78161923919,"97"
"371830523021017","2","5","4","11","2","5","4","11","4","15","15",369,0.270037230051331,1366.47824424009,"198"
"371830525052006","3","3","3","9","3","3","4","10","4","13","14",24,0.00757434828045083,3168.58944312652,"14"
"371830520024001","3","4","5","12","5","5","5","15","4","16","19",26,0.00741238591555956,3507.6425183722,"11"
"371830524063000","1","5","2","8","2","5","2","9","3","11","12",3,0.00952845322298832,314.846484502039,"3"
"371830520024012","3","4","5","12","5","5","5","15","4","16","19",60,0.0130576863227453,4594.99474232931,"24"
"371830537073004","4","4","3","11","4","4","4","12","5","16","17",130,0.0312238104816212,4163.48927292266,"85"
"371830540013002","4","2","3","9","4","2","4","10","3","12","13",398,0.104211786010861,3819.14575342294,"255"
"371830540141029","3","2","1","6","3","3","2","8","5","11","13",160,0.0167092968867171,9575.5076401324,"49"
"371830525032001","2","2","2","6","2","2","3","7","5","11","12",225,0.00532114363004524,42284.1433427135,"75"
"371830525071005","2","2","2","6","2","2","2","6","4","10","10",515,0.167997130474091,3065.52855127145,"275"
"371830537232017","4","2","3","9","4","3","4","11","5","14","16",0,0.0193800321207463,0,"0"
"371830537093043","1","5","1","7","1","5","1","7","2","9","9",142,0.0390288884889948,3638.33061861448,"46"
"371830540072009","2","1","2","5","2","1","3","6","3","8","9",80,0.0471579986769777,1696.42483235947,"39"
"371830525033024","3","5","3","11","3","5","3","11","4","15","15",0,0.00107402532672036,0,"0"
"371830542091052","2","1","1","4","2","1","1","4","3","7","7",77,0.0114435239258607,6728.69655351456,"33"
"371830525052003","1","2","3","6","1","2","3","6","3","9","9",1196,0.152534290135302,7840.85990723213,"690"
"371830524041027","5","5","4","14","5","5","4","14","5","19","19",29,0.0132912308052601,2181.88973052241,"10"
"371830537122018","5","3","3","11","5","3","3","11","5","16","16",75,0.0231265362981068,3243.02779427198,"26"
"371830540061010","3","2","3","8","3","2","3","8","4","12","12",223,0.030509553576286,7309.18593883753,"95"
"371830540132017","2","5","1","8","2","5","2","9","4","12","13",135,0.0154057308247925,8762.97278820062,"34"
"371830525062000","3","2","2","7","3","2","2","7","3","10","10",489,0.141528547144268,3455.13332728226,"237"
"371830537221008","2","2","2","6","2","2","2","6","3","9","9",43,0.00514942880154866,8350.44072986659,"23"
"371830521011030","3","3","4","10","3","3","4","10","2","12","12",61,0.00450487115127425,13540.8978307283,"16"
"371830540181019","3","4","4","11","3","4","4","11","2","13","13",166,0.0196753813296566,8436.93940253086,"82"
"371830541102016","2","1","1","4","2","2","1","5","3","7","8",62,0.165751163516264,374.05468947985,"25"
"371830523021043","1","3","1","5","1","3","1","5","2","7","7",0,0.289378206680155,0,"0"
"371830528072080","2","1","1","4","5","5","2","12","2","6","14",31,0.0160605267445379,1930.19821162111,"15"
"371830540132011","1","3","1","5","1","4","1","6","5","10","11",80,0.00661503281361014,12093.6663889865,"31"
"371830540163009","2","5","2","9","2","5","3","10","5","14","15",0,0.0202645451145875,0,"0"
"371830527012001","2","4","4","10","2","4","4","10","2","12","12",0,0.00189016109053399,0,"0"
"371830537251005","1","5","1","7","1","5","1","7","2","9","9",52,0.0786433065872536,661.213296548089,"18"
"371830537262007","1","5","2","8","1","5","2","8","3","11","11",0,0.00200247991614132,0,"0"
"371830537252009","2","5","2","9","2","5","2","9","3","12","12",47,0.010650858075254,4412.78999944604,"14"
"371830537171006","2","5","1","8","2","5","2","9","2","10","11",175,0.0370571952213684,4722.42971856351,"66"
"371830540134035","1","5","2","8","1","5","2","8","5","13","13",19,0.00783498672863758,2425.02006168731,"10"
"371830540141003","2","3","1","6","2","4","2","8","3","9","11",0,0.00974771337410439,0,"0"
"371830541043050","1","2","2","5","3","2","2","7","2","7","9",0,0.0123550818523653,0,"0"
"371830540141054","1","2","1","4","3","3","2","8","3","7","11",9,0.000269248950130506,33426.3141811237,"5"
"371830527011001","3","2","3","8","3","2","4","9","2","10","11",84,0.0241929632883177,3472.08396916643,"29"
"371830545002026","2","3","4","9","2","3","4","9","3","12","12",418,0.215456272162101,1940.06883998027,"0"
"371830528063008","5","2","2","9","5","2","3","10","3","12","13",4,0.00398810820037953,1002.98181469082,"4"
"371830540181013","2","3","3","8","2","3","3","8","2","10","10",0,0.0693732616071665,0,"0"
"371830515012016","4","2","4","10","4","2","4","10","4","14","14",279,0.11324364880385,2463.71432700174,"100"
"371830540171007","1","4","2","7","1","4","3","8","3","10","11",298,0.0988090401854967,3015.91837589513,"117"
"371830540132057","2","5","2","9","2","5","2","9","4","13","13",0,0.00173220244502071,0,"0"
"371830524043002","4","5","4","13","4","5","4","13","4","17","17",149,0.0454480748265011,3278.46670224889,"59"
"371830524043000","5","5","4","14","5","5","4","14","3","17","17",30,0.00752546788100642,3986.46309762576,"8"
"371830511012015","3","5","4","12","3","5","4","12","4","16","16",0,0.00563441288346554,0,"0"
"371830524043008","3","5","4","12","3","5","4","12","5","17","17",138,0.0195683259933638,7052.21284880473,"38"
"371830524043009","4","5","4","13","4","5","4","13","5","18","18",8,0.00335115610716808,2387.23585060335,"4"
"371830525041005","2","5","3","10","2","5","4","11","5","15","16",8,0.0253026293191464,316.172675143545,"3"
"371830521012012","5","4","5","14","5","5","5","15","3","17","18",64,0.0067064441416394,9543.06017441236,"20"
"371830505003006","4","3","5","12","4","3","5","12","5","17","17",39,0.0234623585221202,1662.23698113005,"15"
"371830519003015","5","3","4","12","5","4","5","14","5","17","19",37,0.00785531508440677,4710.18661917802,"13"
"371830540143019","1","3","2","6","1","3","2","6","3","9","9",0,7.7091506032837e-06,0,"0"
"371830541041018","1","3","2","6","3","4","3","10","4","10","14",0,0.00314560260307049,0,"0"
"371830525043022","3","5","3","11","3","5","4","12","3","14","15",35,0.00318444315187383,10990.9325840547,"17"
"371830524011081","1","5","2","8","1","5","2","8","3","11","11",0,0.0032724496983067,0,"0"
"371830524011061","2","5","3","10","2","5","4","11","4","14","15",2,0.213322476319545,9.37547713914642,"1"
"371830525042009","3","5","3","11","3","5","4","12","4","15","16",199,0.0523688874270966,3799.96615885778,"99"
"371830525041011","2","5","3","10","2","5","4","11","4","14","15",117,0.0292376910409545,4001.68398510379,"45"
"371830524011027","1","5","2","8","1","5","3","9","4","12","13",276,0.0133390909657908,20691.0651338855,"151"
"371830530081010","2","4","2","8","2","4","2","8","3","11","11",0,0.0146674954604947,0,"0"
"371830524072022","3","5","3","11","3","5","4","12","4","15","16",0,0.00280595750620204,0,"0"
"371830541043011","1","3","3","7","5","4","3","12","2","9","14",58,0.0159647178236322,3633.01128405439,"18"
"371830528033048","1","1","2","4","1","2","2","5","3","7","8",229,0.0229782700206688,9965.93737448535,"56"
"371830541132036","5","3","2","10","5","4","2","11","5","15","16",76,0.0253482207271831,2998.23805457471,"29"
"371830537073016","3","3","4","10","3","3","4","10","4","14","14",271,0.0176145009201882,15385.0512840477,"174"
"371830537162008","3","4","4","11","3","4","4","11","4","15","15",37,0.0163933915511184,2257.00703143858,"17"
"371830537162005","3","3","4","10","3","3","4","10","3","13","13",51,0.0204919415706639,2488.78320407722,"23"
"371830536102108","5","5","2","12","5","5","2","12","1","13","13",204,0.0106322029504236,19186.9926628774,"121"
"371830525061016","4","3","3","10","4","3","3","10","4","14","14",7,0.0074159397911628,943.912733533994,"3"
"371830537072008","3","2","3","8","3","2","3","8","5","13","13",120,0.0388050809059804,3092.37855451827,"50"
"371830537071003","3","2","3","8","3","2","3","8","3","11","11",71,0.0363887286888994,1951.15362800952,"31"
"371830537171034","1","1","1","3","4","1","1","6","1","4","7",0,0.0124298519948678,0,"0"
"371830523011009","4","5","3","12","4","5","3","12","4","16","16",65,0.00528139368670953,12307.3574620219,"30"
"371830545004008","2","4","3","9","2","4","3","9","2","11","11",96,0.0142141486559735,6753.83396666927,"41"
"371830540151016","2","3","2","7","2","3","3","8","3","10","11",48,0.00888733029741065,5400.94701037329,"17"
"371830523011002","4","5","4","13","5","5","4","14","4","17","18",0,0.0233672903286236,0,"0"
"371830541101004","2","1","1","4","2","1","1","4","3","7","7",602,0.1333293373833,4515.13531691341,"198"
"371830541102022","1","1","1","3","1","2","1","4","3","6","7",54,0.00475696391392553,11351.7783563421,"16"
"371830530031016","2","3","2","7","2","4","2","8","3","10","11",0,0.00657798655698644,0,"0"
"371830541101013","3","2","1","6","3","3","1","7","4","10","11",11,0.0180614234797149,609.032837990553,"1"
"371830528062035","1","1","2","4","4","2","3","9","5","9","14",164,0.0933976313563077,1755.93318179931,"51"
"371830527051013","5","2","4","11","5","3","4","12","3","14","15",19,0.0090971614414574,2088.56357252424,"10"
"371830541102034","1","1","1","3","3","2","2","7","2","5","9",20,0.0496556121516352,402.774210877216,"7"
"371830527011018","5","3","4","12","5","3","5","13","2","14","15",140,0.0822173997525496,1702.80257489727,"60"
"371830505003004","4","5","5","14","5","5","5","15","4","18","19",47,0.0701857910449844,669.651211452132,"24"
"371830505002019","5","4","5","14","5","5","5","15","3","17","18",67,0.0144912656663672,4623.47468761823,"35"
"371830540171004","2","4","2","8","2","4","2","8","2","10","10",0,0.00669705860600929,0,"0"
"371830542081115","2","4","1","7","2","5","1","8","3","10","11",0,0.00824300487525264,0,"0"
"371830509003014","5","5","5","15","5","5","5","15","5","20","20",49,0.0131532120824837,3725.32577538637,"13"
"371830509003001","5","5","5","15","5","5","5","15","5","20","20",36,0.00307305823806965,11714.7145322613,"17"
"371830516004013","5","4","4","13","5","4","5","14","4","17","18",0,0.00157792988593876,0,"0"
"371830516004014","5","4","5","14","5","4","5","14","3","17","17",72,0.0219956598421641,3273.37304343929,"28"
"371830504001009","3","4","5","12","4","4","5","13","3","15","16",0,0.0024934700236506,0,"0"
"371830505002007","4","4","5","13","4","5","5","14","3","16","17",23,0.00927631877489937,2479.43182615019,"12"
"371830509003007","5","5","5","15","5","5","5","15","5","20","20",86,0.00787289734399972,10923.5515519003,"32"
"371830509003012","5","5","5","15","5","5","5","15","5","20","20",37,0.00753433436721565,4910.85186781716,"12"
"371830540041005","4","3","4","11","4","3","4","11","2","13","13",32,0.00652168064970425,4906.71066536372,"17"
"371830540082010","2","3","3","8","2","3","3","8","2","10","10",176,0.063653788156474,2764.95720203417,"90"
"371830541043043","2","2","2","6","2","2","2","6","3","9","9",23,0.00188250816279951,12217.7425067822,"9"
"371830540083009","2","3","3","8","4","4","4","12","2","10","14",55,0.00396528605342465,13870.373854239,"22"
"371830545001036","5","5","5","15","5","5","5","15","5","20","20",0,0.0378936586523784,0,"0"
"371830520011007","2","3","4","9","3","3","4","10","4","13","14",225,0.00719084856364362,31289.7703252413,"82"
"371830526032012","4","3","4","11","4","4","5","13","5","16","18",88,0.0126111073296745,6977.97566062514,"27"
"371830519001023","3","3","4","10","4","4","5","13","3","13","16",133,0.0344284072441159,3863.08896188425,"45"
"371830530081002","1","2","2","5","4","2","3","9","2","7","11",54,0.0278634865122073,1938.02021065605,"25"
"371830537231014","5","2","3","10","5","2","3","10","4","14","14",0,0.00623077870136756,0,"0"
"371830524061007","1","4","2","7","5","4","3","12","3","10","15",31,0.0218364314326649,1419.64588378792,"15"
"371830537072015","5","4","4","13","5","4","4","13","4","17","17",14,0.016230728497031,862.561406443396,"7"
"371830501001041","5","5","5","15","5","5","5","15","5","20","20",2,0.00864672645445254,231.301407594561,"1"
"371830521011021","3","2","4","9","3","2","4","9","2","11","11",574,0.0621121563822682,9241.34716024552,"181"
"371830545002044","1","2","3","6","1","2","3","6","2","8","8",0,0.0303780178866535,0,"0"
"371830542071103","3","5","1","9","3","5","2","10","4","13","14",210,0.0335955620498093,6250.82562061772,"61"
"371830521011019","4","2","4","10","4","2","4","10","3","13","13",102,0.0108186753778645,9428.14128693576,"36"
"371830536101064","4","1","1","6","4","1","1","6","1","7","7",466,0.127039074253611,3668.1627502237,"284"
"371830538071023","3","2","3","8","3","2","3","8","3","11","11",92,0.0151575325221843,6069.58948399749,"50"
"371830537142017","5","2","3","10","5","2","3","10","5","15","15",43,0.0123721796318487,3475.53957989006,"14"
"371830540072001","1","2","3","6","2","2","3","7","5","11","12",274,0.0533391228289261,5136.94236927736,"124"
"371830528033064","1","1","2","4","1","2","2","5","3","7","8",51,0.0179509616028421,2841.07342705949,"15"
"371830525051019","3","3","4","10","3","4","4","11","5","15","16",16,0.0189848500839474,842.777263410088,"7"
"371839802001001","4","5","2","11","4","5","2","11","2","13","13",0,0.00124898609964468,0,"0"
"371830537252001","2","5","2","9","2","5","2","9","3","12","12",0,0.0372669748818612,0,"0"
"371830545002019","4","4","4","12","4","4","5","13","4","16","17",23,0.0199914196616999,1150.49358120694,"4"
"371830528033047","1","1","2","4","1","2","2","5","3","7","8",72,0.00532785744706287,13513.8750830678,"15"
"371830523023012","3","5","3","11","3","5","3","11","3","14","14",27,0.00132964888970187,20306.1125452854,"10"
"371830528064034","1","1","1","3","1","2","1","4","4","7","8",84,0.00978161161829568,8587.54193868064,"27"
"371830528064047","1","1","1","3","1","2","1","4","4","7","8",158,0.0143868447404266,10982.2551678774,"47"
"371830545002018","4","4","4","12","4","4","5","13","4","16","17",0,0.00105092937371505,0,"0"
"371830521012008","5","4","5","14","5","4","5","14","3","17","17",30,0.00640070775055199,4686.98168533204,"11"
"371830521021023","2","2","4","8","2","3","4","9","3","11","12",6,0.141876722840299,42.2902353527986,"3"
"371830530081023","2","4","2","8","2","4","2","8","3","11","11",163,0.0463287015923351,3518.33732432872,"102"
"371830523011011","4","5","2","11","4","5","3","12","4","15","16",488,0.132810440784081,3674.40991174312,"281"
"371830524011051","1","5","2","8","1","5","3","9","4","12","13",123,0.00525274023040472,23416.3492967028,"65"
"371830524011024","1","5","1","7","1","5","1","7","2","9","9",0,0.0031783417110304,0,"0"
"371830537091006","2","5","2","9","2","5","2","9","3","12","12",89,0.00637167138684931,13968.0775414265,"55"
"371830537111032","4","1","2","7","4","1","2","7","4","11","11",2,0.00179085759438968,1116.7833814735,"1"
"371830516004003","4","4","4","12","4","4","5","13","3","15","16",41,0.00921535211137673,4449.09749562188,"12"
"371830514003012","5","5","5","15","5","5","5","15","5","20","20",0,0.00183753536799254,0,"0"
"371839802001017","1","5","1","7","1","5","1","7","4","11","11",0,0.763013324273026,0,"0"
"371830514002002","4","5","5","14","4","5","5","14","4","18","18",44,0.00860687416437697,5112.19278447358,"18"
"371830512003002","5","5","5","15","5","5","5","15","3","18","18",69,0.0159626579360732,4322.5883982686,"36"
"371830525031007","2","5","2","9","2","5","2","9","5","14","14",5,0.0193189267262662,258.813549574778,"2"
"371830525033004","1","5","2","8","1","5","2","8","5","13","13",16,0.0189670175541048,843.569631037605,"7"
"371830540171027","2","4","3","9","2","4","3","9","2","11","11",0,0.00307988572613207,0,"0"
"371830540134031","1","2","1","4","1","3","2","6","3","7","9",2,0.00335252879734769,596.564599708218,"1"
"371830527061018","3","3","4","10","3","3","4","10","3","13","13",0,0.00218466060595503,0,"0"
"371830540134028","1","3","1","5","1","4","2","7","3","8","10",8,0.0184189636733933,434.33496812615,"2"
"371830527042001","5","3","4","12","5","3","4","12","2","14","14",540,0.055588651707676,9714.21294475169,"206"
"371830527042003","4","2","3","9","4","2","3","9","2","11","11",263,0.0281811539490955,9332.47802680704,"95"
"371830537072010","4","4","4","12","4","4","4","12","4","16","16",90,0.0153725856387337,5854.57789047734,"30"
"371830537241012","3","5","1","9","3","5","2","10","2","11","12",141,0.0426334644262947,3307.26113623167,"75"
"371830524011060","2","5","3","10","2","5","4","11","4","14","15",2,0.131657599438822,15.1909195407239,"1"
"371830527063004","2","2","3","7","2","3","4","9","2","9","11",93,0.0141519210380527,6571.5459936453,"33"
"371830525043017","4","5","4","13","4","5","4","13","4","17","17",215,0.0484200770985592,4440.30684962288,"116"
"371830524012005","3","4","4","11","3","4","4","11","4","15","15",0,0.00946024599536848,0,"0"
"371830537093050","2","5","1","8","2","5","1","8","2","10","10",29,0.0131253776450637,2209.4602368189,"10"
"371830523023014","2","3","2","7","2","3","2","7","2","9","9",256,0.00737780085961833,34698.6866237053,"79"
"371830527072001","3","3","3","9","3","3","4","10","2","11","12",63,0.0332918260554336,1892.35639688552,"23"
"371830541055008","2","3","2","7","2","3","3","8","3","10","11",31,0.0500437463364045,619.458019621703,"11"
"371830530081049","1","4","2","7","1","4","2","7","3","10","10",39,0.0132776393170059,2937.26912358955,"11"
"371830540163011","2","5","3","10","2","5","3","10","4","14","14",4,0.00427119458840854,936.506150025446,"2"
"371830540141038","2","2","1","5","3","4","2","9","4","9","13",0,0.000541919442479457,0,"0"
"371830527041009","5","3","4","12","5","4","4","13","2","14","15",0,0.00205477948665403,0,"0"
"371830536102042","4","1","1","6","4","1","1","6","1","7","7",0,0.00878837336769739,0,"0"
"371830536102046","3","1","1","5","3","1","1","5","1","6","6",0,0.0131071827121209,0,"0"
"371830523013011","3","5","3","11","3","5","4","12","4","15","16",314,0.0507261632818144,6190.09954006458,"141"
"371830524062006","1","5","2","8","3","5","3","11","3","11","14",8,0.0188580399162572,424.222243431743,"5"
"371830541102000","2","1","1","4","2","1","1","4","3","7","7",1502,0.489858656086634,3066.1905864829,"459"
"371830536101076","1","5","1","7","1","5","1","7","1","8","8",108,0.00593180653665451,18206.9322950157,"58"
"371830541061005","2","1","1","4","2","1","2","5","3","7","8",3,0.0397698077157288,75.4341087451,"1"
"371830520022001","3","4","5","12","5","5","5","15","4","16","19",248,0.0431239290790127,5750.86744868745,"55"
"371830528063014","3","1","1","5","3","2","2","7","3","8","10",0,0.0513816181335095,0,"0"
"371830504002014","5","4","5","14","5","5","5","15","4","18","19",17,0.00630993239158506,2694.16515819904,"10"
"371830505001002","5","4","5","14","5","5","5","15","3","17","18",13,0.00338224668731878,3843.59900439596,"10"
"371830524071001","4","5","4","13","4","5","5","14","4","17","18",0,0.0134538630796751,0,"0"
"371830524082006","5","5","4","14","5","5","4","14","4","18","18",42,0.00132975722795649,31584.7126956729,"11"
"371830527062012","2","2","4","8","2","2","4","8","4","12","12",0,0.00622371710968426,0,"0"
"371830542102044","1","1","1","3","1","1","1","3","3","6","6",258,0.0416448027739298,6195.25085520422,"94"
"371830541102035","1","1","1","3","2","1","1","4","2","5","6",12,0.0350789649890644,342.085349546114,"4"
"371830541052017","1","3","2","6","1","3","3","7","3","9","10",95,0.0139308122861002,6819.41569873774,"40"
"371830521011016","3","2","4","9","3","2","4","9","2","11","11",209,0.0336100052653911,6218.38641052555,"72"
"371830545002059","1","2","3","6","1","2","3","6","2","8","8",0,0.0132834762757329,0,"0"
"371830541103009","2","1","1","4","2","2","1","5","3","7","8",107,0.0124711093484054,8579.83015068997,"33"
"371830542071026","1","4","1","6","1","4","1","6","2","8","8",141,0.00211550165190445,66650.857905531,"70"
"371830537192000","1","1","1","3","1","1","1","3","1","4","4",75,0.0125341617215512,5983.64706520783,"25"
"371830525033032","2","5","3","10","2","5","4","11","4","14","15",0,0.182516809656761,0,"0"
"371830527051009","5","3","4","12","5","3","4","12","2","14","14",181,0.0858109948487556,2109.28681480756,"78"
"371830537093034","1","5","1","7","1","5","1","7","2","9","9",26,0.00737082124869926,3527.42240284124,"10"
"371830537161004","5","5","4","14","5","5","4","14","5","19","19",125,0.0153092513616137,8164.99755915065,"81"
"371830541062024","1","1","1","3","1","1","2","4","2","5","6",0,0.00441385583676735,0,"0"
"371830515011004","5","2","3","10","5","2","4","11","5","15","16",5,0.0639999570580911,78.1250524193575,"1"
"371830524011086","1","5","3","9","1","5","4","10","5","14","15",0,0.00543682257601524,0,"0"
"371830536101019","2","5","1","8","2","5","1","8","1","9","9",46,0.00164046140763464,28040.8912918755,"26"
"371830525052011","3","3","4","10","3","4","4","11","5","15","16",25,0.00795558222942229,3142.44756437084,"7"
"371830525071002","2","2","2","6","2","2","2","6","4","10","10",68,0.0390215773074443,1742.6256110623,"30"
"371830541102003","3","2","1","6","3","2","1","6","4","10","10",44,0.00555775418774905,7916.86686989309,"13"
"371830540061003","3","2","3","8","3","3","3","9","5","13","14",223,0.0645545090098077,3454.44498642411,"103"
"371830540071010","1","4","3","8","1","4","4","9","3","11","12",2,0.0119762902069246,166.996621277899,"1"
"371830537241022","2","5","2","9","2","5","2","9","3","12","12",111,0.117507573137321,944.619968197998,"45"
"371830537241014","1","5","1","7","1","5","1","7","1","8","8",0,0.00320735010286892,0,"0"
"371830541102010","1","1","1","3","1","1","1","3","3","6","6",89,0.00935933995342431,9509.21757761748,"28"
"371830527061029","3","2","4","9","3","2","5","10","3","12","13",0,0.0738673931722288,0,"0"
"371830541062026","4","5","4","13","4","5","5","14","3","16","17",0,0.0127352715426754,0,"0"
"371830525033001","1","5","2","8","1","5","2","8","5","13","13",2,0.0154719497100819,129.266190588556,"1"
"371830537152007","2","2","3","7","2","2","3","7","3","10","10",8,0.00800037524284747,999.953096844076,"3"
"371830525033013","3","5","3","11","3","5","3","11","5","16","16",4,0.0488372049776389,81.9047691576838,"1"
"371830525031019","2","5","2","9","2","5","2","9","4","13","13",13,0.0345050492194008,376.756454318884,"5"
"371830541043009","1","3","2","6","2","3","3","8","3","9","11",32,0.0109014006196953,2935.40262543753,"11"
"371830527011012","5","3","4","12","5","3","4","12","2","14","14",28,0.00654851845479262,4275.77629860809,"11"
"371830527011011","5","3","4","12","5","3","4","12","2","14","14",29,0.00945451527648928,3067.31748290839,"9"
"371830524081009","4","4","5","13","4","5","5","14","5","18","19",340,0.0110323293819444,30818.5142256945,"112"
"371830525042007","4","5","3","12","4","5","4","13","4","16","17",101,0.019779598554412,5106.27148079662,"59"
"371830509001027","4","5","5","14","4","5","5","14","5","19","19",0,0.00237263404973917,0,"0"
"371830526031001","3","3","4","10","3","3","5","11","4","14","15",90,0.0336074507852395,2677.97758821768,"36"
"371830525051003","4","3","4","11","4","3","4","11","5","16","16",54,0.0200888582101545,2688.05720241005,"21"
"371830540111009","2","4","3","9","2","4","3","9","3","12","12",200,0.0468079829292158,4272.7754430787,"75"
"371830521014017","4","5","5","14","4","5","5","14","5","19","19",34,0.00938631907221439,3622.29322681429,"18"
"371830540171045","1","3","2","6","1","4","2","7","2","8","9",0,0.0697079095869229,0,"0"
"371830527012011","3","3","4","10","3","3","4","10","2","12","12",0,0.00024219939996382,0,"0"
"371830525032000","2","2","2","6","2","2","3","7","5","11","12",0,0.0702728654911016,0,"0"
"371830542102041","1","1","1","3","1","2","1","4","3","6","7",120,0.0097040421946494,12365.9808555001,"42"
"371830542102042","1","1","1","3","1","2","1","4","3","6","7",59,0.0049857026821745,11833.8384298254,"19"
"371830545001033","4","5","5","14","4","5","5","14","4","18","18",91,0.089813582046078,1013.20978327435,"30"
"371830545001010","5","5","5","15","5","5","5","15","5","20","20",106,0.0156903235344314,6755.75616827719,"36"
"371830525032024","4","5","3","12","4","5","3","12","3","15","15",46,0.0347383351682784,1324.18550794585,"22"
"371830520024000","3","4","5","12","5","4","5","14","4","16","18",292,0.0655262077656942,4456.23224594533,"81"
"371830541102002","2","1","1","4","2","1","1","4","3","7","7",69,0.0130957663923694,5268.8783483649,"25"
"371830512002022","4","5","5","14","5","5","5","15","4","18","19",0,0.0013488971964914,0,"0"
"371830542091031","1","1","1","3","1","1","1","3","3","6","6",32,0.157329910828198,203.394254986539,"5"
"371830525043012","4","5","4","13","4","5","4","13","4","17","17",578,0.122088848758974,4734.25710763381,"244"
"371830524011067","1","5","2","8","1","5","2","8","3","11","11",2,0.0922299938381734,21.6849195881895,"1"
"371830525043043","3","5","3","11","3","5","4","12","3","14","15",23,0.00318043640268517,7231.71196901835,"15"
"371830524012003","4","4","4","12","4","4","5","13","4","16","17",0,0.00615203642752804,0,"0"
"371830524011078","1","5","2","8","2","5","2","9","3","11","12",0,0.00128868574919963,0,"0"
"371830524011100","1","5","2","8","1","5","2","8","4","12","12",0,0.00558903328280855,0,"0"
"371830524011099","1","5","3","9","1","5","4","10","4","13","14",0,0.00837785032959129,0,"0"
"371830525032013","2","5","2","9","2","5","2","9","3","12","12",35,0.0206969144480214,1691.07332824415,"15"
"371830520022005","5","4","5","14","5","4","5","14","5","19","19",71,0.0146846707824212,4834.9739025129,"27"
"371830541042018","5","5","3","13","5","5","3","13","4","17","17",107,0.00717937738784556,14903.7993435402,"23"
"371839801001018","1","5","1","7","1","5","1","7","1","8","8",0,0.0792972720336327,0,"0"
"371830519001015","4","4","5","13","4","4","5","13","3","16","16",82,0.110490582873292,742.144695661852,"30"
"371830523021001","4","5","5","14","4","5","5","14","5","19","19",26,0.00964966344444306,2694.39448843914,"14"
"371830523021031","5","5","5","15","5","5","5","15","4","19","19",0,0.0994596319790279,0,"0"
"371830512002018","4","5","5","14","5","5","5","15","4","18","19",14,0.00336031132636779,4166.28063303076,"7"
"371830526012021","5","4","4","13","5","4","5","14","5","18","19",49,0.0130673699627893,3749.79817205243,"20"
"371830519001012","4","4","5","13","5","4","5","14","4","17","18",69,0.0176209239505325,3915.79920517816,"35"
"371830519001024","4","4","5","13","5","5","5","15","4","17","19",0,0.00618207042100886,0,"0"
"371830527052015","2","2","4","8","2","2","4","8","3","11","11",17,0.143384635595045,118.562215048008,"6"
"371830537224004","4","2","3","9","4","2","3","9","4","13","13",160,0.0456389811435957,3505.77501931048,"111"
"371830537112006","3","5","2","10","3","5","2","10","3","13","13",67,0.0654394518407066,1023.84720708071,"26"
"371830537111030","3","1","2","6","3","1","2","6","4","10","10",190,0.0497390201491199,3819.93853980982,"64"
"371830527051018","3","3","4","10","3","4","5","12","3","13","15",91,0.04099026604867,2220.03926229585,"53"
"371830528062057","5","4","4","13","5","5","4","14","4","17","18",0,0.0158658962597252,0,"0"
"371830541062014","2","1","2","5","2","2","3","7","3","8","10",0,0.00528640479636234,0,"0"
"371830521021003","4","5","4","13","4","5","4","13","5","18","18",238,0.0200251691900383,11885.0431545115,"77"
"371830521021007","4","3","4","11","4","4","4","12","5","16","17",216,0.0201673277476887,10710.3927055857,"64"
"371830503001003","5","5","5","15","5","5","5","15","3","18","18",197,0.0309815345495036,6358.62628706222,"130"
"371830545001034","4","5","5","14","4","5","5","14","4","18","18",124,0.0066440053152708,18663.4408185969,"72"
"371830541061012","1","1","2","4","1","2","3","6","2","6","8",52,0.0266781874082202,1949.15790958038,"13"
"371830524012017","5","4","4","13","5","4","5","14","5","18","19",0,0.000244230612443394,0,"0"
"371830536101033","1","1","1","3","1","1","1","3","1","4","4",32,0.00209374081357455,15283.6491472733,"26"
"371830536102048","2","1","1","4","2","1","1","4","1","5","5",0,0.00388567077977166,0,"0"
"371830536102115","5","5","2","12","5","5","2","12","1","13","13",45,0.00343094775319139,13115.9094329379,"23"
"371830538071017","4","2","2","8","4","2","2","8","3","11","11",254,0.0370488725762548,6855.80916064887,"122"
"371830536101015","1","1","1","3","1","1","1","3","1","4","4",139,0.0239219786483252,5810.55614351245,"44"
"371830537221004","2","2","2","6","2","2","2","6","3","9","9",144,0.0346546540075171,4155.28603946714,"57"
"371830537072005","3","2","3","8","3","2","3","8","4","12","12",274,0.0626261462114578,4375.16942324435,"121"
"371830537152001","4","2","3","9","4","3","3","10","4","13","14",281,0.0955332687514638,2941.38370509482,"111"
"371830517001014","5","4","5","14","5","4","5","14","4","18","18",57,0.0107091049323179,5322.57367541385,"22"
"371830517001010","5","5","5","15","5","5","5","15","5","20","20",51,0.0161971336547749,3148.70526396906,"22"
"371830541041050","4","3","2","9","4","3","2","9","4","13","13",98,0.0137299174986206,7137.69765986179,"24"
"371830518002011","4","4","5","13","4","4","5","13","3","16","16",13,0.00164992502083283,7879.1459223026,"8"
"371830537192002","1","1","1","3","1","1","1","3","1","4","4",105,0.0147281892528083,7129.18595746449,"33"
"371830519001026","2","4","4","10","4","4","5","13","4","14","17",0,0.0139793590919903,0,"0"
"371830514001006","5","5","5","15","5","5","5","15","4","19","19",27,0.00902825834884852,2990.61003315702,"12"
"371830526032011","4","3","4","11","4","3","5","12","4","15","16",115,0.0315869810072492,3640.74046752386,"38"
"371830541041042","4","3","2","9","4","4","2","10","5","14","15",0,0.0711515182682562,0,"0"
"371830540083002","2","2","3","7","4","3","4","11","2","9","13",0,0.000479944879697905,0,"0"
"371830540143010","2","2","2","6","2","3","2","7","2","8","9",33,0.00233401135577736,14138.7486904532,"10"
"371830523023032","2","5","3","10","2","5","3","10","3","13","13",3,0.00288027045481241,1041.56885510093,"1"
"371830526032013","4","3","4","11","4","3","5","12","4","15","16",47,0.0105345870255301,4461.49430310817,"15"
"371830530081045","2","4","2","8","2","4","2","8","3","11","11",102,0.00903598143910226,11288.2037980518,"29"
"371830523021000","3","5","5","13","3","5","5","13","5","18","18",58,0.140146009639952,413.854095089881,"22"
"371830511023009","5","5","5","15","5","5","5","15","5","20","20",0,0.00376872710476768,0,"0"
"371830507003016","5","4","5","14","5","5","5","15","4","18","19",24,0.00863295169115669,2780.04567366974,"9"
"371830511021015","5","5","5","15","5","5","5","15","4","19","19",0,0.000632477802258053,0,"0"
"371830540141050","3","4","2","9","3","5","2","10","4","13","14",29,0.00407608294424709,7114.67366995808,"17"
"371830523021034","4","5","5","14","4","5","5","14","5","19","19",0,0.0100363737234227,0,"0"
"371830525041008","2","5","3","10","2","5","4","11","4","14","15",86,0.0253080450985057,3398.12892166364,"36"
"371830545003019","2","2","3","7","2","2","3","7","3","10","10",109,0.00785706283240693,13872.8685674274,"60"
"371830527052021","4","2","4","10","4","2","4","10","3","13","13",61,0.012079489433453,5049.88230968323,"24"
"371830527051011","4","3","4","11","4","3","4","11","2","13","13",36,0.00889335607449111,4047.96566093413,"15"
"371830537181008","1","1","1","3","3","1","1","5","1","4","6",413,0.0682086623894965,6054.94940864869,"139"
"371830541062055","5","2","2","9","5","2","3","10","3","12","13",116,0.0561831583535024,2064.67566793117,"46"
"371830524012001","3","5","4","12","3","5","5","13","5","17","18",0,0.00546174394275968,0,"0"
"371830538082019","1","3","3","7","2","3","3","8","5","12","13",21,0.0324120978261891,647.906226638374,"10"
"371830538071018","3","2","3","8","3","2","3","8","3","11","11",0,0.0545529511528461,0,"0"
"371830520011000","1","2","3","6","2","3","4","9","4","10","13",1028,0.180307892675108,5701.3588520627,"423"
"371830510002019","5","5","5","15","5","5","5","15","5","20","20",48,0.00351568322622736,13653.1072088393,"16"
"371830514005000","5","4","5","14","5","5","5","15","3","17","18",224,0.0317989556354742,7044.25650225162,"151"
"371830503002014","4","5","5","14","4","5","5","14","4","18","18",86,0.00854456490960543,10064.8776046306,"70"
"371830501001033","4","5","5","14","5","5","5","15","3","17","18",0,0.00248693667287311,0,"0"
"371830501001015","4","5","5","14","5","5","5","15","3","17","18",44,0.00517794484646215,8497.57989022675,"2"
"371830501001026","4","5","5","14","4","5","5","14","4","18","18",0,0.00839526322114641,0,"0"
"371830501001085","5","5","5","15","5","5","5","15","5","20","20",0,0.0036199517800662,0,"0"
"371830526023000","2","2","3","7","2","2","4","8","3","10","11",671,0.149189031401473,4497.64968440819,"492"
"371830545001008","5","5","5","15","5","5","5","15","4","19","19",11,0.0676772508902889,162.536152921342,"3"
"371830501001112","5","5","5","15","5","5","5","15","5","20","20",0,0.00398824810245997,0,"0"
"371830545001029","5","5","5","15","5","5","5","15","5","20","20",82,0.0133097547207368,6160.8949015599,"28"
"371830523023025","3","4","3","10","4","4","3","11","2","12","13",154,0.0162846249172652,9456.77292430156,"56"
"371830530091014","1","5","3","9","1","5","3","9","2","11","11",0,0.109094139913651,0,"0"
"371830541041007","3","3","1","7","3","4","2","9","5","12","14",0,0.00293678570248844,0,"0"
"371830523022010","2","5","3","10","4","5","3","12","3","13","15",850,0.0888299058659816,9568.84949627665,"339"
"371830542071099","3","4","1","8","3","5","1","9","3","11","12",270,0.0404239655766802,6679.20616268676,"70"
"371830538071010","5","2","3","10","5","2","3","10","2","12","12",129,0.0357201852121757,3611.40344692358,"43"
"371830540162030","3","4","2","9","3","5","3","11","3","12","14",0,0.00359657639842536,0,"0"
"371830541061018","2","2","2","6","2","2","3","7","3","9","10",0,0.0277820606245286,0,"0"
"371830542071088","4","5","1","10","4","5","1","10","3","13","13",270,0.0533583129731842,5060.12999578325,"76"
"371830542071086","3","4","1","8","3","5","1","9","3","11","12",343,0.0464629779930148,7382.22160558814,"91"
"371830540131010","2","5","1","8","2","5","2","9","4","12","13",72,0.0246501507663644,2920.87463003453,"18"
"371830541042032","4","3","2","9","4","3","2","9","4","13","13",53,0.00498055379861711,10641.3869105712,"14"
"371830540132009","1","3","1","5","1","4","1","6","5","10","11",172,0.0616327289972691,2790.72503843893,"89"
"371830540132036","1","4","1","6","1","5","2","8","5","11","13",126,0.0147435823035834,8546.09126910601,"51"
"371830540141005","2","2","1","5","3","4","2","9","4","9","13",141,0.0115524780831662,12205.1735554002,"46"
"371830541043045","3","2","3","8","4","3","3","10","2","10","12",0,0.00249072393153857,0,"0"
"371830537112000","2","5","2","9","2","5","2","9","3","12","12",20,0.0109766265594703,1822.05342339396,"5"
"371830537112005","1","5","1","7","1","5","1","7","2","9","9",60,0.0244314364880371,2455.8523208154,"21"
"371830540083006","2","2","3","7","5","3","4","12","2","9","14",129,0.0313834270985123,4110.44974773055,"50"
"371830527043006","4","2","3","9","4","3","4","11","2","11","13",24,0.0164246112171536,1461.22180200739,"8"
"371830540141027","1","2","1","4","1","3","2","6","4","8","10",64,0.00422117311149994,15161.6620094641,"20"
"371830528062028","2","1","2","5","4","3","3","10","5","10","15",236,0.0219996069710924,10727.4643728911,"82"
"371830540112001","3","4","3","10","3","4","3","10","4","14","14",30,0.0159796121098885,1877.39225418591,"12"
"371830537093028","1","5","1","7","1","5","1","7","2","9","9",51,0.0394178945054262,1293.82861869955,"19"
"371830541043033","1","2","2","5","4","3","3","10","2","7","12",92,0.0107645059078052,8546.60685664092,"25"
"371830536102024","3","5","1","9","3","5","2","10","1","10","11",0,0.00240768892662935,0,"0"
"371830536102009","4","5","1","10","4","5","2","11","1","11","12",28,0.00332307821389073,8425.9226529661,"15"
"371830536101054","3","5","1","9","3","5","2","10","1","10","11",0,0.00164520878878815,0,"0"
"371830537241056","1","5","2","8","1","5","2","8","2","10","10",0,0.00511945714664065,0,"0"
"371830537241081","1","5","2","8","1","5","2","8","3","11","11",106,0.00562855165493798,18832.5534699509,"56"
"371830518003015","5","4","5","14","5","4","5","14","5","19","19",0,0.00530926741894764,0,"0"
"371830518001012","5","4","5","14","5","4","5","14","4","18","18",56,0.0115522075395304,4847.55833968305,"26"
"371830504001034","5","4","5","14","5","4","5","14","3","17","17",37,0.00817830006562553,4524.16757799287,"17"
"371830541053027","4","3","2","9","4","3","2","9","5","14","14",154,0.0312792192387842,4923.39654722104,"65"
"371830541052034","3","3","2","8","3","3","2","8","4","12","12",67,0.0120973316311534,5538.41144831142,"26"
"371830541053010","5","3","2","10","5","3","2","10","5","15","15",46,0.00260424354842025,17663.4785283058,"23"
"371830541044001","2","2","3","7","5","3","4","12","2","9","14",0,0.00114014073503815,0,"0"
"371830525051016","5","5","3","13","5","5","4","14","5","18","19",48,0.0057764583188989,8309.58995115708,"22"
"371830537093012","1","5","1","7","1","5","1","7","2","9","9",145,0.0107493815079681,13489.1481795968,"77"
"371830525052000","3","4","3","10","3","4","4","11","4","14","15",122,0.0798667222224385,1527.54484727964,"47"
"371830537093047","2","5","1","8","2","5","1","8","2","10","10",91,0.134324223266759,677.465298416654,"35"
"371830521013004","3","3","4","10","3","3","4","10","3","13","13",218,0.0199176790007636,10945.0503741748,"64"
"371830537252044","1","5","2","8","1","5","2","8","3","11","11",242,0.0172862824799138,13999.5398247829,"115"
"371830520021006","5","4","4","13","5","4","5","14","5","18","19",158,0.0314124017106336,5029.86054538182,"56"
"371830527051020","2","3","3","8","2","3","4","9","3","11","12",183,0.0732736014046715,2497.48881577879,"79"
"371830526011007","3","4","3","10","3","4","4","11","5","15","16",190,0.0909384972926502,2089.32416585419,"77"
"371830540141000","1","1","1","3","5","5","2","12","5","8","17",6,0.263806581675723,22.7439359620502,"3"
"371830505002020","4","4","5","13","5","5","5","15","3","16","18",61,0.0104638394778063,5829.60013189998,"26"
"371830538083002","4","5","2","11","4","5","3","12","5","16","17",113,0.0271133079948908,4167.69506772444,"54"
"371830527012030","2","2","4","8","2","2","4","8","3","11","11",29,0.00955293622448525,3035.71585934697,"13"
"371830541055006","2","3","2","7","2","3","3","8","3","10","11",53,0.123475110459634,429.236303597611,"23"
"371830541054025","4","4","3","11","4","4","3","11","3","14","14",82,0.0110438577693511,7424.9416927087,"32"
"371830538071026","5","3","3","11","5","3","3","11","3","14","14",0,0.00112586350904499,0,"0"
"371830541051006","4","2","2","8","4","2","2","8","4","12","12",70,0.00589107826695523,11882.3748094895,"20"
"371830541052013","2","3","2","7","2","3","3","8","3","10","11",12,0.119195913564096,100.674592284132,"5"
"371830545003016","1","4","3","8","1","4","3","8","2","10","10",32,0.00549204519769131,5826.60900413781,"17"
"371830542071030","1","2","1","4","1","2","1","4","2","6","6",125,0.00897172919139296,13932.6541554463,"45"
"371830542102031","2","1","1","4","2","2","1","5","3","7","8",9,0.00800826415474386,1123.83905252035,"3"
"371830525033009","1","5","1","7","1","5","1","7","5","12","12",2,0.0564040865495868,35.4584237126459,"1"
"371830537252038","1","5","2","8","1","5","2","8","3","11","11",0,0.00371937409978421,0,"0"
"371830536101079","1","5","1","7","1","5","1","7","1","8","8",123,0.0165034264860944,7452.99772163303,"83"
"371839802001003","1","1","1","3","1","1","1","3","1","4","4",0,0.0663491233725447,0,"0"
"371830540151030","2","2","2","6","2","2","3","7","2","8","9",57,0.0371956892639952,1532.43564315866,"25"
"371830541061035","2","3","4","9","2","3","4","9","4","13","13",252,0.0383451898112557,6571.88036466647,"117"
"371830540171056","2","3","2","7","2","4","2","8","2","9","10",0,0.00535623757869032,0,"0"
"371830540162008","4","5","3","12","4","5","3","12","5","17","17",38,0.00643091551105245,5908.95649844747,"23"
"371830540132037","1","4","1","6","1","5","2","8","5","11","13",56,0.00426671037535255,13124.8655459472,"27"
"371830540111008","2","3","3","8","2","3","3","8","3","11","11",168,0.029021732146134,5788.76543805396,"60"
"371830527063023","1","2","3","6","1","3","4","8","3","9","11",0,0.0880608022593424,0,"0"
"371830540132033","1","4","1","6","1","5","2","8","5","11","13",0,0.000437091491287201,0,"0"
"371830527013001","3","3","4","10","3","3","4","10","3","13","13",181,0.134590677690264,1344.81825269161,"74"
"371830540143031","1","2","1","4","1","3","2","6","3","7","9",0,0.000205919518234947,0,"0"
"371830540182016","2","3","3","8","2","4","3","9","2","10","11",0,0.00338825124477082,0,"0"
"371830541041043","2","2","2","6","4","3","3","10","2","8","12",4,0.0108236529275609,369.561000040436,"3"
"371830545001009","5","5","5","15","5","5","5","15","5","20","20",29,0.0374459445613715,774.449685798976,"7"
"371830537252010","2","5","2","9","2","5","2","9","3","12","12",142,0.0304610256060788,4661.69464667213,"42"
"371830541131015","1","1","1","3","4","3","2","9","4","7","13",25,0.0118406727719123,2111.36651451963,"10"
"371830540141065","2","3","1","6","2","4","2","8","4","10","12",93,0.0820475480052196,1133.48908359923,"35"
"371830527012012","3","3","4","10","3","3","4","10","2","12","12",55,0.00797568018148317,6895.96357282372,"28"
"371830541041025","3","3","2","8","3","3","2","8","4","12","12",6,0.00224530783532082,2672.23937208712,"1"
"371830540081015","5","4","3","12","5","4","3","12","2","14","14",28,0.00230651818314051,12139.5097617985,"17"
"371830540131036","4","5","3","12","4","5","3","12","5","17","17",0,0.000505339463839233,0,"0"
"371830527012002","2","3","4","9","2","3","4","9","2","11","11",27,0.0110304401014898,2447.77177987244,"16"
"371830541131009","1","1","1","3","4","3","2","9","4","7","13",52,0.0200315751365331,2595.9017024659,"18"
"371830536102007","1","5","1","7","1","5","1","7","1","8","8",0,0.00754638416064055,0,"0"
"371830545001007","4","5","5","14","4","5","5","14","4","18","18",0,0.0044812955858023,0,"0"
"371830524043001","5","5","4","14","5","5","4","14","3","17","17",92,0.0603097652783585,1525.45776915854,"43"
"371830503001032","5","5","5","15","5","5","5","15","3","18","18",16,0.0034638159268176,4619.18310269451,"8"
"371830527071011","3","4","3","10","3","4","4","11","2","12","13",93,0.0614947686189516,1512.32376490866,"37"
"371830537241084","1","5","2","8","1","5","2","8","3","11","11",0,0.00221859841949096,0,"0"
"371830537241090","2","5","1","8","2","5","1","8","1","9","9",0,0.149611391605117,0,"0"
"371830525071008","2","2","2","6","2","2","2","6","4","10","10",46,0.0154329634241766,2980.63299547114,"20"
"371830537232010","4","1","3","8","4","1","3","8","3","11","11",41,0.00332425447953017,12333.5924648569,"21"
"371830537093007","3","5","1","9","3","5","1","9","2","11","11",75,0.00492291773562089,15234.8676187133,"45"
"371830537143008","2","2","3","7","2","2","3","7","3","10","10",398,0.0428770952781465,9282.34521061065,"202"
"371830537073014","3","4","3","10","3","4","4","11","5","15","16",175,0.034399477669516,5087.28654781526,"113"
"371830537112015","3","5","2","10","3","5","2","10","3","13","13",34,0.007639099742023,4450.78623767204,"12"
"371830530081054","2","3","2","7","2","3","2","7","3","10","10",4,0.00782377047129855,511.262442408552,"3"
"371830524093008","3","5","4","12","3","5","4","12","5","17","17",869,0.0603856400618781,14390.8386018517,"372"
"371830524082003","5","5","4","14","5","5","5","15","4","18","19",919,0.0824681044724367,11143.7022334757,"423"
"371830511021007","4","5","5","14","4","5","5","14","5","19","19",0,0.0404822934548587,0,"0"
"371830511021006","4","5","5","14","4","5","5","14","5","19","19",0,0.00762893881835626,0,"0"
"371830537251004","4","5","3","12","4","5","3","12","4","16","16",2,0.00999416046297649,200.116858980705,"1"
"371830523013015","4","5","3","12","4","5","3","12","4","16","16",397,0.0763663979419547,5198.621523327,"227"
"371830545003025","2","4","3","9","2","4","4","10","3","12","13",54,0.00367914822116458,14677.3102777868,"28"
"371830540182015","2","4","3","9","2","4","3","9","2","11","11",0,0.00830874294852194,0,"0"
"371830540072003","1","2","3","6","3","2","3","8","5","11","13",5,0.00442477350862152,1130.00134136983,"2"
"371830527041001","3","3","4","10","3","3","4","10","2","12","12",0,0.0206663031977464,0,"0"
"371830527012025","3","2","4","9","3","3","4","10","3","12","13",50,0.0751493671637389,665.341597502181,"29"
"371830540121003","3","4","3","10","3","4","3","10","2","12","12",84,0.0252917862094735,3321.23636125535,"33"
"371830537121000","1","1","2","4","1","1","2","4","2","6","6",581,0.386099346284413,1504.79405259603,"220"
"371830537111033","4","1","2","7","4","1","2","7","4","11","11",14,0.00986109952894175,1419.71997736265,"5"
"371830537181007","1","1","1","3","3","1","1","5","2","5","7",72,0.00760570495521373,9466.57810472175,"25"
"371830537171018","1","5","1","7","3","5","2","10","1","8","11",0,0.0490797290251477,0,"0"
"371830535211068","1","5","2","8","1","5","2","8","2","10","10",0,0.00266256229232818,0,"0"
"371839802001007","1","5","1","7","1","5","1","7","1","8","8",0,0.825080965223534,0,"0"
"371830525071015","3","2","2","7","3","2","3","8","3","10","11",0,0.00346011820534015,0,"0"
"371830537141000","2","2","2","6","2","2","2","6","3","9","9",0,0.00200175252434626,0,"0"
"371830540041001","4","3","4","11","4","3","4","11","2","13","13",44,0.0507550616199671,866.908611587427,"17"
"371830527041002","2","3","4","9","2","3","4","9","2","11","11",0,0.0607483007894811,0,"0"
"371830526011002","3","4","4","11","4","4","4","12","4","15","16",58,0.0255427408407758,2270.70385130363,"23"
"371830540131007","2","5","2","9","2","5","2","9","3","12","12",146,0.0447049036926991,3265.86096692215,"47"
"371830523021038","5","5","5","15","5","5","5","15","5","20","20",0,0.0136873562899867,0,"0"
"371830510002031","5","5","5","15","5","5","5","15","5","20","20",92,0.0117012138405261,7862.43215907789,"35"
"371830537131000","5","3","3","11","5","3","3","11","5","16","16",59,0.0143868204260165,4100.97563276087,"19"
"371830537112001","2","5","2","9","2","5","2","9","3","12","12",124,0.12317080010445,1006.73211422551,"52"
"371830541102019","1","1","1","3","1","2","1","4","2","5","6",72,0.0101243380827466,7111.57602714778,"19"
"371830537112008","3","5","2","10","3","5","2","10","3","13","13",106,0.0234808148115266,4514.32375114876,"34"
"371830537091014","1","5","2","8","1","5","2","8","3","11","11",360,0.0446041387295123,8070.99991736431,"156"
"371830537252023","1","5","1","7","1","5","1","7","2","9","9",117,0.113553658014849,1030.34989841278,"41"
"371830526012009","3","4","4","11","3","4","5","12","4","15","16",41,0.0104848133077582,3910.41774388698,"16"
"371830540162020","2","4","2","8","3","4","3","10","2","10","12",0,0.0199233996337524,0,"0"
"371830540181025","2","4","4","10","2","4","4","10","2","12","12",0,0.019269204495489,0,"0"
"371830540151050","5","4","3","12","5","4","3","12","2","14","14",420,0.109348522097868,3840.92982641408,"154"
"371830540141028","2","2","1","5","2","3","2","7","4","9","11",92,0.0039355827144687,23376.4620577718,"39"
"371830540132019","2","4","1","7","2","5","2","9","4","11","13",92,0.0150085023922203,6129.85876909933,"35"
"371830540131028","2","5","2","9","2","5","2","9","4","13","13",46,0.0123831825560711,3714.71548543451,"15"
"371830537171030","1","5","1","7","3","5","2","10","1","8","11",135,0.00834683132197907,16173.8023439524,"66"
"371830540131031","3","5","2","10","3","5","2","10","5","15","15",144,0.03711437406562,3879.89838506777,"54"
"371830541041023","3","3","3","9","3","4","3","10","3","12","13",0,0.00448897827474079,0,"0"
"371830540132045","1","4","1","6","1","4","1","6","5","11","11",35,0.00377969554695358,9260.00508908974,"9"
"371830537241065","1","5","2","8","1","5","2","8","2","10","10",0,0.0242899448740268,0,"0"
"371830527073030","3","4","3","10","3","4","4","11","3","13","14",2,0.00691690740171984,289.146562740266,"1"
"371830541052014","2","3","3","8","2","3","3","8","3","11","11",41,0.0100942535674709,4061.7168694993,"17"
"371830527052014","3","1","3","7","3","2","4","9","3","10","12",81,0.0151239090663889,5355.75820010798,"33"
"371830528033018","1","2","4","7","2","3","4","9","3","10","12",12,0.0472092110209485,254.187683727126,"6"
"371830540141004","1","2","1","4","2","3","2","7","3","7","10",543,0.318385113447075,1705.48174856882,"207"
"371830540141010","1","2","1","4","1","3","2","6","3","7","9",110,0.00262826730242882,41852.6684475158,"39"
"371830540181010","2","3","3","8","2","3","3","8","2","10","10",23,0.0213809583242114,1075.72353171632,"12"
"371830527012015","2","3","4","9","2","3","4","9","2","11","11",107,0.120332734133066,889.201103680381,"44"
"371830528072041","1","1","1","3","1","1","1","3","2","5","5",0,0.256940991140111,0,"0"
"371830540132042","1","4","1","6","1","5","2","8","5","11","13",47,0.00433314706793711,10846.6200807662,"21"
"371830514005004","5","4","5","14","5","4","5","14","3","17","17",163,0.0787792258126696,2069.07339236362,"76"
"371830515012034","3","4","4","11","3","4","5","12","3","14","15",0,0.00111704860356207,0,"0"
"371830545002021","4","4","4","12","4","4","5","13","4","16","17",34,0.0115277786653312,2949.3973632797,"7"
"371830526021014","3","2","4","9","3","2","4","9","2","11","11",150,0.0396732162663094,3780.88832004731,"59"
"371830512002006","5","5","5","15","5","5","5","15","3","18","18",0,0.00495894665783398,0,"0"
"371830508003005","5","5","5","15","5","5","5","15","4","19","19",55,0.00427878715858337,12854.1098123258,"17"
"371830510001016","4","5","5","14","4","5","5","14","4","18","18",10,0.00329633549078474,3033.67179340698,"9"
"371830501001014","4","5","5","14","4","5","5","14","4","18","18",0,0.00110999337377533,0,"0"
"371830503002012","4","5","5","14","4","5","5","14","3","17","17",0,0.00312742676573695,0,"0"
"371830501001058","5","5","5","15","5","5","5","15","4","19","19",0,0.00519297328509767,0,"0"
"371830510002025","5","5","5","15","5","5","5","15","5","20","20",46,0.00580843702958394,7919.51427995338,"22"
"371830537111009","3","1","2","6","3","1","2","6","3","9","9",155,0.118411667437399,1308.99263015567,"53"
"371830527073006","2","3","3","8","2","3","4","9","2","10","11",31,0.00492568751321344,6293.53768724482,"14"
"371830523021021","2","5","4","11","2","5","4","11","4","15","15",0,0.107325118183809,0,"0"
"371830545004011","4","5","4","13","4","5","4","13","3","16","16",65,0.00917510272831249,7084.3893441567,"27"
"371830545002081","3","4","4","11","3","4","5","12","5","16","17",123,0.113898982582607,1079.90429072351,"45"
"371830503002004","5","5","5","15","5","5","5","15","3","18","18",276,0.00815100773080598,33860.8438508632,"225"
"371830527012003","2","3","4","9","2","3","4","9","2","11","11",389,0.0588332005604764,6611.91293851395,"216"
"371830527011000","3","2","4","9","3","3","4","10","2","11","12",88,0.0338793219787397,2597.45457879064,"28"
"371830540142006","5","2","2","9","5","4","2","11","3","12","14",90,0.0298519547947634,3014.87794078355,"27"
"371830540181033","3","3","4","10","3","3","4","10","2","12","12",0,0.0462635516103037,0,"0"
"371830523013009","4","5","3","12","4","5","4","13","4","16","17",18,0.011852044983181,1518.72525167964,"7"
"371830525033017","3","5","3","11","3","5","3","11","4","15","15",464,0.0448038112193892,10356.2618306721,"272"
"371830527073033","2","4","3","9","2","4","4","10","2","11","12",158,0.0542645414977349,2911.66193685789,"52"
"371830527043016","4","3","4","11","4","3","4","11","2","13","13",113,0.0161252139857986,7007.65894328712,"34"
"371830525043004","2","2","2","6","2","2","3","7","4","10","11",515,0.0983838116057348,5234.60101407558,"303"
"371830540181000","2","2","3","7","2","2","3","7","2","9","9",8,0.234560840322979,34.106289817961,"5"
"371830540151004","2","3","2","7","2","4","3","9","2","9","11",0,0.00339326285758029,0,"0"
"371830541041004","2","3","1","6","2","4","2","8","5","11","13",0,0.00336255834153283,0,"0"
"371830541052002","2","2","2","6","2","2","2","6","4","10","10",138,0.0206298931561311,6689.32208982318,"47"
"371830541063005","3","3","2","8","3","3","3","9","4","12","13",89,0.00953690103425691,9332.17191625546,"25"
"371830537251025","3","5","3","11","3","5","3","11","5","16","16",66,0.044216553872974,1492.65363803805,"28"
"371830537251007","3","5","2","10","3","5","2","10","3","13","13",543,0.0841051135497757,6456.20672848433,"266"
"371830526011015","3","4","4","11","3","4","4","11","3","14","14",35,0.0379031567678384,923.405937251596,"14"
"371830523021039","5","5","5","15","5","5","5","15","5","20","20",4,0.00349707762325219,1143.812185753,"2"
"371830536102027","4","5","2","11","4","5","2","11","1","12","12",88,0.0120900266137316,7278.72673994376,"45"
"371830536101050","1","1","1","3","1","1","1","3","1","4","4",401,0.196166951762715,2044.17714807055,"121"
"371830536102047","3","1","1","5","3","1","1","5","1","6","6",0,0.0130750309423003,0,"0"
"371830537231006","3","2","3","8","3","2","3","8","3","11","11",24,0.00857102300027579,2800.13249284569,"13"
"371830525051029","5","5","3","13","5","5","4","14","5","18","19",0,0.000581524646595512,0,"0"
"371830537093013","1","5","1","7","1","5","1","7","2","9","9",13,0.00244766208710066,5311.19065352642,"6"
"371830537142033","2","3","3","8","2","3","3","8","3","11","11",0,0.00116946913132059,0,"0"
"371830540111013","1","4","3","8","1","5","3","9","3","11","12",0,0.0187559601734504,0,"0"
"371830537132001","5","3","3","11","5","3","3","11","5","16","16",362,0.0485605092214483,7454.61705002284,"211"
"371830536101002","1","1","1","3","1","1","1","3","1","4","4",285,0.170948535771956,1667.16841833724,"158"
"371830509003000","5","5","5","15","5","5","5","15","5","20","20",41,0.0574979083790743,713.069416885459,"19"
"371830501001037","5","5","5","15","5","5","5","15","4","19","19",32,0.00847314367099538,3776.63842872628,"22"
"371830514001007","5","5","5","15","5","5","5","15","4","19","19",85,0.0146654623247198,5795.93047378571,"55"
"371830524063001","1","5","2","8","2","5","2","9","2","10","11",62,0.091635741221633,676.591897151188,"27"
"371830538082003","1","3","3","7","3","3","3","9","5","12","14",219,0.152421797203778,1436.80237352937,"79"
"371830538071020","4","2","3","9","4","2","3","9","3","12","12",42,0.00404325950437415,10387.6587576342,"25"
"371830541041010","2","3","1","6","2","4","2","8","5","11","13",0,0.00827326535841668,0,"0"
"371830525043005","3","5","3","11","3","5","4","12","4","15","16",57,0.00661130886580594,8621.59084637645,"35"
"371830516004017","5","5","5","15","5","5","5","15","4","19","19",13,0.0106881614690636,1216.29899002068,"7"
"371830516004011","5","4","4","13","5","4","5","14","3","16","17",43,0.0140915594533828,3051.47206327667,"25"
"371830514002006","5","5","5","15","5","5","5","15","4","19","19",32,0.0114417374339815,2796.778040454,"18"
"371830514002007","5","5","5","15","5","5","5","15","4","19","19",93,0.0111238553466643,8360.41076602887,"42"
"371830540134010","1","4","1","6","1","4","1","6","5","11","11",0,0.000497998681951417,0,"0"
"371830511022006","3","5","5","13","3","5","5","13","5","18","18",0,0.00147852992685202,0,"0"
"371830524012011","5","5","5","15","5","5","5","15","5","20","20",0,0.0109846318301494,0,"0"
"371830515012030","3","4","4","11","3","4","5","12","3","14","15",54,0.00200863326750454,26883.9518261528,"32"
"371830501001019","5","5","5","15","5","5","5","15","4","19","19",35,0.00465075650227296,7525.65738130871,"26"
"371830501001099","5","5","5","15","5","5","5","15","5","20","20",2,0.00473295400050189,422.569076265671,"1"
"371830527072022","5","5","3","13","5","5","4","14","2","15","16",109,0.0702602739161297,1551.37453819372,"40"
"371830527063012","2","2","3","7","2","2","4","8","3","10","11",0,0.00787405749414517,0,"0"
"371830527042002","5","3","4","12","5","3","4","12","2","14","14",62,0.00668772959481504,9270.70975597881,"23"
"371830538083027","4","5","2","11","4","5","2","11","4","15","15",85,0.0157716238249501,5389.42603142316,"34"
"371830538071016","4","2","3","9","4","2","3","9","3","12","12",0,0.0559567019260231,0,"0"
"371830540083004","2","3","3","8","4","4","4","12","2","10","14",164,0.00962357712812997,17041.48029537,"64"
"371830541054017","4","5","4","13","4","5","4","13","2","15","15",17,0.0349178736560341,486.856678830506,"9"
"371830526031011","3","3","4","10","3","3","5","11","3","13","14",86,0.00330248354463957,26041.0078771145,"34"
"371830540134025","1","4","1","6","1","4","1","6","4","10","10",74,0.00882945245099914,8381.04066029895,"33"
"371830527042004","4","2","4","10","4","2","4","10","2","12","12",120,0.0266880242343343,4496.39879469306,"44"
"371830516003016","5","4","5","14","5","5","5","15","3","17","18",0,0.00633909745088445,0,"0"
"371830516001020","4","4","5","13","5","4","5","14","3","16","17",75,0.0161232552483275,4651.66610866499,"32"
"371830516005015","3","4","5","12","5","4","5","14","3","15","17",120,0.0264197169671866,4542.0622843553,"43"
"371830541053014","4","3","2","9","4","3","2","9","5","14","14",145,0.0130508854706914,11110.3572493705,"67"
"371830528062044","1","1","2","4","4","3","3","10","5","9","15",9,0.00280171150478915,3212.32217686072,"9"
"371830542071028","1","4","1","6","1","4","1","6","2","8","8",15,0.0030317154870927,4947.6938267662,"10"
"371830528064052","2","1","1","4","2","2","1","5","4","8","9",212,0.0191963840326995,11043.746553459,"66"
"371830540082013","3","3","3","9","3","4","4","11","2","11","13",0,0.00107349959216563,0,"0"
"371830526021011","3","3","4","10","3","3","4","10","3","13","13",78,0.0330271093755439,2361.69623908285,"28"
"371830541103014","1","1","1","3","5","2","2","9","2","5","11",67,0.0119478178224276,5607.71858056227,"23"
"371830540112005","2","4","3","9","2","4","3","9","3","12","12",139,0.038142822008766,3644.19811329259,"57"
"371830545001025","5","5","5","15","5","5","5","15","4","19","19",66,0.0100753943983567,6550.61205452807,"23"
"371830510002007","5","5","5","15","5","5","5","15","4","19","19",57,0.00472191616161605,12071.3706150369,"13"
"371830541042027","5","5","3","13","5","5","3","13","5","18","18",199,0.268832502962906,740.237872306156,"69"
"371830541052019","2","3","3","8","2","3","3","8","3","11","11",55,0.00744461060695124,7387.89480119282,"19"
"371830540112010","1","4","3","8","1","4","3","8","3","11","11",519,0.205903044363522,2520.60381916309,"187"
"371830540141068","2","3","1","6","2","4","2","8","4","10","12",51,0.00886494115187701,5752.99927278159,"22"
"371830503001024","5","5","5","15","5","5","5","15","3","18","18",88,0.056019200319076,1570.88997163056,"52"
"371830504001001","3","4","5","12","3","4","5","12","3","15","15",0,0.0843252704151699,0,"0"
"371830524093005","5","5","4","14","5","5","5","15","4","18","19",186,0.0173046575955884,10748.551306061,"74"
"371830518002015","4","4","5","13","4","4","5","13","3","16","16",60,0.0147557014225736,4066.22486330679,"19"
"371830518001035","4","4","5","13","5","5","5","15","3","16","18",0,0.00224365116429863,0,"0"
"371830503001010","5","5","5","15","5","5","5","15","3","18","18",42,0.00773359301090498,5430.85212019519,"29"
"371830503001011","5","5","5","15","5","5","5","15","3","18","18",100,0.00978339069675355,10221.4051446584,"69"
"371830501001010","4","5","5","14","5","5","5","15","3","17","18",5,0.00898622772236156,556.40699907458,"3"
"371830526012007","4","3","4","11","4","4","4","12","4","15","16",192,0.053989936228903,3556.21831420528,"72"
"371830541063026","3","3","2","8","3","3","2","8","4","12","12",55,0.00515868877901499,10661.6239816083,"16"
"371830541131004","1","1","1","3","2","1","1","4","3","6","7",173,0.992543855149294,174.299603088045,"66"
"371830536102043","4","1","1","6","4","1","1","6","1","7","7",0,0.137925301156972,0,"0"
"371830528071006","2","1","1","4","3","3","2","8","3","7","11",60,0.00745259664442402,8050.88519648941,"19"
"371830536101073","1","5","1","7","1","5","1","7","1","8","8",519,0.0619002100662543,8384.46266086163,"290"
"371830540132015","1","4","1","6","1","5","2","8","5","11","13",29,0.00940118754826332,3084.71667553927,"7"
"371830527051002","3","3","4","10","3","3","4","10","2","12","12",50,0.057664238715846,867.088530317493,"20"
"371830538083001","4","5","2","11","4","5","3","12","5","16","17",13,0.00236884069596494,5487.91652479801,"6"
"371830508001005","5","5","5","15","5","5","5","15","5","20","20",0,0.00116112047078521,0,"0"
"371830538082016","1","1","2","4","5","1","3","9","3","7","12",165,0.13067669235201,1262.65822183141,"56"
"371830541063011","3","3","2","8","3","3","2","8","4","12","12",70,0.0107496584224562,6511.83481828308,"23"
"371830545003031","2","2","3","7","2","2","3","7","3","10","10",17,0.00227358796197086,7477.16837190831,"15"
"371830526031007","5","3","4","12","5","3","5","13","5","17","18",52,0.0250020084916949,2079.83290691519,"22"
"371830528071008","2","1","1","4","4","3","1","8","3","7","11",777,0.191194717310812,4063.91981393966,"247"
"371830541051045","3","2","2","7","3","2","2","7","3","10","10",0,0.00145003252583242,0,"0"
"371830541052032","2","3","3","8","2","4","3","9","3","11","12",13,0.0834772308969731,155.731088110056,"5"
"371830517002002","4","4","4","12","4","5","5","14","5","17","19",88,0.0193847658964739,4539.64729158826,"24"
"371830516002006","2","4","4","10","3","4","5","12","3","13","15",54,0.0129829345656174,4159.30618205593,"26"
"371830527072023","4","4","3","11","4","4","4","12","2","13","14",78,0.0299133004555002,2607.53573869372,"32"
"371830541055005","4","3","2","9","4","3","3","10","4","13","14",68,0.0737761380562084,921.70723206184,"27"
"371830541043013","1","2","2","5","5","3","3","11","2","7","13",0,0.0402478177399613,0,"0"
"371830541052028","1","3","3","7","1","3","3","7","3","10","10",0,0.00246090249886961,0,"0"
"371830537072002","4","2","3","9","4","2","3","9","5","14","14",72,0.0181392371186227,3969.29592623722,"31"
"371830537163008","5","4","4","13","5","4","4","13","5","18","18",75,0.0189021442682434,3967.80380763487,"31"
"371830540011011","4","3","4","11","4","3","4","11","3","14","14",38,0.00759888183159789,5000.73574535497,"13"
"371830540011009","4","3","4","11","4","4","4","12","3","14","15",129,0.0318975607478341,4044.19638917874,"50"
"371830540061007","1","3","3","7","1","3","3","7","3","10","10",87,0.0280320146668895,3103.59426654986,"35"
"371830540011008","4","4","4","12","4","4","4","12","4","16","16",30,0.0219283035869783,1368.09488618239,"13"
"371830536102106","4","5","2","11","4","5","2","11","1","12","12",0,0.0069055277981008,0,"0"
"371830530081025","4","5","3","12","4","5","3","12","4","16","16",0,0.0100112453588958,0,"0"
"371830537142008","3","3","3","9","3","3","3","9","4","13","13",468,0.144112108045231,3247.47175201347,"159"
"371830530081034","3","5","2","10","3","5","2","10","4","14","14",56,0.0207292318594387,2701.49904153353,"23"
"371830537161000","4","4","4","12","4","4","4","12","4","16","16",389,0.180704514761177,2152.68556247259,"176"
"371830537162003","5","5","4","14","5","5","4","14","5","19","19",60,0.0132160444535811,4539.9363032365,"28"
"371830524092003","3","5","5","13","3","5","5","13","5","18","18",0,0.0379833408371386,0,"0"
"371830528062032","2","2","2","6","4","3","3","10","5","11","15",134,0.00964920648396734,13887.152298238,"37"
"371830540181002","2","4","3","9","2","4","3","9","2","11","11",0,0.0039089207288901,0,"0"
"371830520024004","3","4","5","12","5","4","5","14","4","16","18",38,0.00655368901542657,5798.26108784728,"15"
"371830541102041","1","1","1","3","4","2","2","8","2","5","10",23,0.111326032997794,206.600373521401,"8"
"371830523021033","4","5","5","14","4","5","5","14","5","19","19",41,0.122713152390889,334.11251525345,"25"
"371830511023002","5","5","5","15","5","5","5","15","5","20","20",0,0.0205062794794322,0,"0"
"371830510001007","4","5","5","14","5","5","5","15","5","19","20",139,0.0090801987803809,15308.0349188313,"38"
"371830535211030","1","5","2","8","1","5","2","8","2","10","10",0,0.0179214520163388,0,"0"
"371830541061047","1","1","1","3","1","1","2","4","2","5","6",0,0.00519333663033859,0,"0"
"371830527052008","5","3","4","12","5","3","5","13","3","15","16",236,0.0254299497218371,9280.39585533836,"70"
"371830528062010","1","1","1","3","5","3","3","11","4","7","15",188,0.296258197029676,634.581597690505,"57"
"371830541043029","2","2","2","6","3","3","3","9","3","9","12",180,0.0263087358253842,6841.8338758157,"56"
"371830541053007","4","3","2","9","4","3","2","9","5","14","14",818,0.211020040862798,3876.4090683304,"372"
"371830541053016","3","2","1","6","3","2","2","7","4","10","11",100,0.00629921716299106,15874.9884965891,"51"
"371830505002000","5","5","5","15","5","5","5","15","4","19","19",111,0.0210775313498077,5266.27137485019,"39"
"371830524062030","2","4","3","9","4","4","4","12","3","12","15",341,0.0402056581325531,8481.39331224887,"123"
"371830518002017","5","4","5","14","5","5","5","15","3","17","18",74,0.00781889986407416,9464.24705347756,"28"
"371830518002028","5","4","5","14","5","5","5","15","3","17","18",40,0.00518636915706672,7712.52465619378,"15"
"371830504001008","3","4","5","12","4","4","5","13","3","15","16",0,0.00241003243623541,0,"0"
"371830541131007","1","1","1","3","1","1","1","3","2","5","5",37,0.209624490320214,176.506094032622,"19"
"371830527063021","1","2","3","6","1","3","4","8","3","9","11",0,0.107351500566903,0,"0"
"371830541051018","4","2","2","8","4","2","2","8","4","12","12",0,0.000530807209904485,0,"0"
"371830527062003","4","2","4","10","4","2","4","10","3","13","13",0,0.000731720965807969,0,"0"
"371830528062031","2","2","2","6","4","4","4","12","5","11","17",221,0.0114358631419009,19325.1700599895,"54"
"371830545002033","4","4","4","12","4","4","5","13","4","16","17",127,0.0309131907591172,4108.27859827261,"39"
"371830535211070","1","5","2","8","1","5","2","8","3","11","11",0,0.00793982252532449,0,"0"
"371830541103024","1","1","1","3","4","2","2","8","2","5","10",228,0.0403313490274974,5653.17068478301,"77"
"371830537111010","1","5","1","7","1","5","1","7","2","9","9",23,0.020443807608574,1125.03504436982,"8"
"371830542081126","2","4","1","7","2","5","1","8","3","10","11",67,0.00688911764085783,9725.48350787884,"20"
"371830516003002","3","4","5","12","4","4","5","13","3","15","16",92,0.0298124669028356,3085.95730436684,"34"
"371830516003007","4","4","5","13","5","5","5","15","3","16","18",80,0.0292163312975726,2738.1945797776,"28"
"371830535211002","4","5","3","12","4","5","3","12","5","17","17",50,0.117298080645988,426.264434376407,"24"
"371830536102000","1","5","1","7","1","5","1","7","1","8","8",0,0.0109062638242747,0,"0"
"371830523022000","3","5","4","12","3","5","5","13","5","17","18",0,0.0158455650043349,0,"0"
"371830545002034","3","4","4","11","3","4","5","12","4","15","16",0,0.00263741243489076,0,"0"
"371830537232000","3","2","3","8","3","2","3","8","4","12","12",0,0.0480178484071959,0,"0"
"371830525072017","2","5","2","9","2","5","2","9","4","13","13",0,0.00166436214266893,0,"0"
"371830517003015","4","3","4","11","4","3","5","12","5","16","17",0,0.00678234226780873,0,"0"
"371830537093040","1","5","1","7","1","5","1","7","2","9","9",12,0.0211293789324018,567.929612999559,"5"
"371830521021047","2","2","3","7","2","3","4","9","4","11","13",106,0.00476581858692954,22241.7194583758,"32"
"371830512003009","5","5","5","15","5","5","5","15","4","19","19",119,0.0111901501675219,10634.3523740533,"60"
"371830512003007","5","5","5","15","5","5","5","15","3","18","18",231,0.00852437561422744,27098.7589536123,"120"
"371830541102025","1","1","1","3","1","1","1","3","2","5","5",117,0.0180822656686623,6470.42810585227,"37"
"371830542091062","3","1","1","5","3","1","1","5","3","8","8",187,0.0503352526606186,3715.09012303628,"62"
"371830537261015","3","5","2","10","3","5","2","10","4","14","14",100,0.0305556539460733,3272.71673440492,"41"
"371830541102005","1","1","1","3","1","1","1","3","3","6","6",85,0.00879029132618237,9669.75915198883,"29"
"371830537241017","2","5","1","8","2","5","1","8","2","10","10",211,0.0359935557901718,5862.16047200357,"67"
"371830540171026","2","4","3","9","2","4","3","9","2","11","11",0,0.0193386023504284,0,"0"
"371830540142004","4","3","2","9","4","4","2","10","4","13","14",249,0.0240665429494735,10346.3135741084,"69"
"371830545001046","5","5","5","15","5","5","5","15","5","20","20",0,0.0399184648826088,0,"0"
"371830520022007","4","4","5","13","4","4","5","13","5","18","18",198,0.0300555265729112,6587.8067223236,"83"
"371830521014000","3","4","4","11","3","4","5","12","4","15","16",0,0.108285232913781,0,"0"
"371830520012015","4","4","5","13","4","5","5","14","3","16","17",116,0.019000161752575,6105.21118244055,"52"
"371830520024005","3","4","5","12","5","4","5","14","3","15","17",56,0.0129541919542761,4322.92498039715,"23"
"371830519001043","3","4","5","12","4","4","5","13","3","15","16",0,0.00127568846392222,0,"0"
"371830541062025","4","4","4","12","4","4","4","12","3","15","15",0,0.00646996726735365,0,"0"
"371830510002028","5","5","5","15","5","5","5","15","5","20","20",0,0.000906300640243704,0,"0"
"371830520012001","2","3","4","9","4","4","5","13","4","13","17",0,0.0240763841291971,0,"0"
"371830530081039","2","4","2","8","2","4","2","8","3","11","11",55,0.00273837057176431,20084.9368478876,"31"
"371830545004003","4","5","4","13","4","5","4","13","3","16","16",995,0.297435850596579,3345.25914749109,"423"
"371830520012014","3","4","5","12","4","5","5","14","3","15","17",0,0.000602711979431193,0,"0"
"371830530081024","5","5","4","14","5","5","4","14","5","19","19",0,0.0529249553455838,0,"0"
"371830541063017","5","3","2","10","5","4","3","12","5","15","17",57,0.164771804849897,345.932971068232,"21"
"371830542071067","1","2","1","4","1","2","1","4","2","6","6",193,0.025662196900696,7520.7902404788,"59"
"371830542071033","1","4","1","6","1","4","1","6","2","8","8",6,0.003707171939693,1618.48441281007,"2"
"371830541103023","1","1","1","3","3","2","1","6","2","5","8",112,0.0393545637850337,2845.92152035472,"45"
"371830541102013","2","1","1","4","2","1","1","4","3","7","7",300,0.0419194912652777,7156.57540072517,"92"
"371830530082015","4","5","2","11","4","5","2","11","2","13","13",2,0.130888669251645,15.2801614642046,"1"
"371830541103011","1","1","1","3","1","2","1","4","3","6","7",16,0.00923228319755401,1733.04909063438,"5"
"371830542091066","3","2","1","6","3","3","1","7","4","10","11",376,0.091898913768112,4091.45205947438,"108"
"371830542102029","1","1","1","3","1","1","1","3","3","6","6",155,0.570259576655452,271.806044729785,"63"
"371830542071063","1","4","1","6","1","4","1","6","2","8","8",62,0.0154620939379452,4009.80619111666,"15"
"371830542071102","2","5","1","8","2","5","1","8","3","11","11",139,0.222803993352334,623.866735548992,"39"
"371830526031016","4","3","4","11","4","3","5","12","5","16","17",24,0.0102771661741643,2335.27410117523,"14"
"371830511012003","5","4","4","13","5","4","5","14","4","17","18",193,0.0208389649133917,9261.49647077591,"71"
"371830507003042","4","4","5","13","4","4","5","13","5","18","18",18,0.0466934920544355,385.492693050576,"11"
"371830517001000","5","4","5","14","5","5","5","15","5","19","20",109,0.0508979964827455,2141.53812590543,"42"
"371830528061026","1","2","2","5","3","3","3","9","3","8","12",72,0.044272861010536,1626.27845494027,"34"
"371830528072031","1","1","2","4","1","2","2","5","3","7","8",0,0.0137305062398503,0,"0"
"371830528072032","1","1","1","3","1","1","2","4","3","6","7",3,0.0824653539137053,36.3789137816507,"1"
"371830545004014","3","5","4","12","3","5","4","12","3","15","15",157,0.0218923168920655,7171.4657143896,"66"
"371830528072075","3","1","1","5","3","3","2","8","2","7","10",74,0.0932889883289324,793.2340282122,"24"
"371830530081021","2","3","2","7","2","4","2","8","3","10","11",127,0.00967038102091844,13132.8848082904,"52"
"371830527073037","1","3","3","7","1","3","3","7","2","9","9",96,0.180943936690649,530.551074303896,"45"
"371830527062009","3","2","3","8","3","2","4","9","3","11","12",180,0.0358374611104865,5022.67723277221,"107"
"371830528062041","1","1","2","4","4","3","3","10","5","9","15",65,0.00553206946578719,11749.671691939,"22"
"371830523011010","4","5","3","12","4","5","3","12","4","16","16",0,0.0126687159446654,0,"0"
"371830528062045","2","2","2","6","2","3","3","8","4","10","12",77,0.0110746266354962,6952.83033318714,"21"
"371830528063001","3","2","2","7","3","3","2","8","5","12","13",73,0.242933233204156,300.494086532213,"22"
"371830523023015","2","5","3","10","3","5","3","11","2","12","13",119,0.00460240858471773,25856.0268627907,"46"
"371830545002012","4","4","4","12","4","4","5","13","4","16","17",0,0.000874005485921164,0,"0"
"371830523021022","1","5","4","10","1","5","4","10","3","13","13",40,0.524656163908809,76.2404080073906,"16"
"371830545003022","3","5","4","12","3","5","4","12","3","15","15",90,0.0096053199815828,9369.80758294004,"54"
"371830545003023","2","4","3","9","2","4","4","10","3","12","13",136,0.00967444638487622,14057.6519409529,"96"
"371830542071058","1","2","1","4","1","2","1","4","2","6","6",179,0.0199236008619132,8984.31971412277,"58"
"371830542091045","2","1","1","4","2","1","1","4","3","7","7",0,0.00268487566141674,0,"0"
"371830541101000","2","1","1","4","2","2","1","5","3","7","8",252,0.0503828110935055,5001.70583043318,"93"
"371830542091060","2","1","1","4","2","1","1","4","3","7","7",0,0.00509328597320931,0,"0"
"371830541102037","1","1","1","3","2","2","1","5","2","5","7",31,0.0125312750638691,2473.81051345534,"14"
"371830538082006","3","4","3","10","3","4","3","10","4","14","14",35,0.0673389763653966,519.758420592586,"13"
